Week,DFI_Arrival Date,Name,Type 1 Attendances,Total attendances,Attendances,Breaches,Within,4 Hour Performance
10/04/2011,10/04/2011,Cambridge University Hospitals NHS Foundation Trust,1927,1927,1927,126,1801,0.93461338868708
10/04/2011,10/04/2011,East And North Hertfordshire NHS Trust,2672,3154,3154,200,2954,0.93658845909956
10/04/2011,10/04/2011,Ipswich Hospital NHS Trust,1236,1236,1236,46,1190,0.96278317152104
10/04/2011,10/04/2011,Mid Essex Hospital Services NHS Trust,1407,1462,1462,70,1392,0.95212038303694
10/04/2011,10/04/2011,The Princess Alexandra Hospital NHS Trust,1653,1653,1653,197,1456,0.88082274652148
17/04/2011,17/04/2011,Cambridge University Hospitals NHS Foundation Trust,1704,1704,1704,93,1611,0.94542253521127
17/04/2011,17/04/2011,East And North Hertfordshire NHS Trust,2403,2814,2814,52,2762,0.98152096659559
17/04/2011,17/04/2011,Ipswich Hospital NHS Trust,1155,1155,1155,25,1130,0.97835497835498
17/04/2011,17/04/2011,Mid Essex Hospital Services NHS Trust,1280,1308,1308,28,1280,0.97859327217125
17/04/2011,17/04/2011,The Princess Alexandra Hospital NHS Trust,1625,1625,1625,125,1500,0.92307692307692
24/04/2011,24/04/2011,Cambridge University Hospitals NHS Foundation Trust,1957,1957,1957,121,1836,0.93817066939193
24/04/2011,24/04/2011,East And North Hertfordshire NHS Trust,2511,2943,2943,90,2853,0.96941896024465
24/04/2011,24/04/2011,Ipswich Hospital NHS Trust,1247,1247,1247,51,1196,0.95910184442662
24/04/2011,24/04/2011,Mid Essex Hospital Services NHS Trust,1320,1355,1355,32,1323,0.97638376383764
24/04/2011,24/04/2011,The Princess Alexandra Hospital NHS Trust,1590,1590,1590,89,1501,0.9440251572327
01/05/2011,01/05/2011,Cambridge University Hospitals NHS Foundation Trust,2020,2020,2020,86,1934,0.95742574257426
01/05/2011,01/05/2011,East And North Hertfordshire NHS Trust,2725,3154,3154,103,3051,0.96734305643627
01/05/2011,01/05/2011,Ipswich Hospital NHS Trust,1224,1224,1224,84,1140,0.93137254901961
01/05/2011,01/05/2011,Mid Essex Hospital Services NHS Trust,1433,1461,1461,74,1387,0.94934976043806
01/05/2011,01/05/2011,The Princess Alexandra Hospital NHS Trust,1380,1380,1380,111,1269,0.9195652173913
08/05/2011,08/05/2011,Cambridge University Hospitals NHS Foundation Trust,1945,1945,1945,115,1830,0.94087403598972
08/05/2011,08/05/2011,East And North Hertfordshire NHS Trust,2635,3057,3057,217,2840,0.92901537455021
08/05/2011,08/05/2011,Ipswich Hospital NHS Trust,1224,1224,1224,65,1159,0.9468954248366
08/05/2011,08/05/2011,Mid Essex Hospital Services NHS Trust,1400,1430,1430,204,1226,0.85734265734266
08/05/2011,08/05/2011,The Princess Alexandra Hospital NHS Trust,1656,1656,1656,66,1590,0.96014492753623
15/05/2011,15/05/2011,Cambridge University Hospitals NHS Foundation Trust,1906,1906,1906,61,1845,0.96799580272823
15/05/2011,15/05/2011,East And North Hertfordshire NHS Trust,2631,3029,3029,115,2914,0.96203367448003
15/05/2011,15/05/2011,Ipswich Hospital NHS Trust,1199,1199,1199,33,1166,0.97247706422018
15/05/2011,15/05/2011,Mid Essex Hospital Services NHS Trust,1367,1400,1400,73,1327,0.94785714285714
15/05/2011,15/05/2011,The Princess Alexandra Hospital NHS Trust,1677,1677,1677,154,1523,0.90816935002982
22/05/2011,22/05/2011,Cambridge University Hospitals NHS Foundation Trust,1928,1928,1928,60,1868,0.96887966804979
22/05/2011,22/05/2011,East And North Hertfordshire NHS Trust,2629,3108,3108,173,2935,0.94433719433719
22/05/2011,22/05/2011,Ipswich Hospital NHS Trust,1235,1235,1235,69,1166,0.94412955465587
22/05/2011,22/05/2011,Mid Essex Hospital Services NHS Trust,1378,1412,1412,91,1321,0.93555240793201
22/05/2011,22/05/2011,The Princess Alexandra Hospital NHS Trust,1612,1612,1612,35,1577,0.97828784119107
29/05/2011,29/05/2011,Cambridge University Hospitals NHS Foundation Trust,1818,1818,1818,60,1758,0.96699669966997
29/05/2011,29/05/2011,East And North Hertfordshire NHS Trust,2528,2961,2961,51,2910,0.98277608915907
29/05/2011,29/05/2011,Ipswich Hospital NHS Trust,1160,1160,1160,22,1138,0.98103448275862
29/05/2011,29/05/2011,Mid Essex Hospital Services NHS Trust,1410,1450,1450,18,1432,0.98758620689655
29/05/2011,29/05/2011,The Princess Alexandra Hospital NHS Trust,1643,1643,1643,60,1583,0.96348143639684
05/06/2011,05/06/2011,Cambridge University Hospitals NHS Foundation Trust,1821,1821,1821,38,1783,0.97913234486546
05/06/2011,05/06/2011,East And North Hertfordshire NHS Trust,2427,2844,2844,42,2802,0.98523206751055
05/06/2011,05/06/2011,Ipswich Hospital NHS Trust,1224,1224,1224,21,1203,0.9828431372549
05/06/2011,05/06/2011,Mid Essex Hospital Services NHS Trust,1511,1542,1542,38,1504,0.97535667963684
05/06/2011,05/06/2011,The Princess Alexandra Hospital NHS Trust,1619,1619,1619,92,1527,0.9431747992588
12/06/2011,12/06/2011,Cambridge University Hospitals NHS Foundation Trust,1794,1794,1794,45,1749,0.97491638795987
12/06/2011,12/06/2011,East And North Hertfordshire NHS Trust,2442,2835,2835,64,2771,0.97742504409171
12/06/2011,12/06/2011,Ipswich Hospital NHS Trust,1111,1111,1111,19,1092,0.98289828982898
12/06/2011,12/06/2011,Mid Essex Hospital Services NHS Trust,1322,1354,1354,14,1340,0.98966026587888
12/06/2011,12/06/2011,The Princess Alexandra Hospital NHS Trust,1595,1595,1595,26,1569,0.98369905956113
19/06/2011,19/06/2011,Cambridge University Hospitals NHS Foundation Trust,1892,1892,1892,48,1844,0.97463002114165
19/06/2011,19/06/2011,East And North Hertfordshire NHS Trust,2491,2857,2857,116,2741,0.95939796989849
19/06/2011,19/06/2011,Ipswich Hospital NHS Trust,1152,1152,1152,27,1125,0.9765625
19/06/2011,19/06/2011,Mid Essex Hospital Services NHS Trust,1363,1385,1385,69,1316,0.95018050541516
19/06/2011,19/06/2011,The Princess Alexandra Hospital NHS Trust,1633,1633,1633,122,1511,0.92529087568892
26/06/2011,26/06/2011,Cambridge University Hospitals NHS Foundation Trust,1967,1967,1967,58,1909,0.97051347229283
26/06/2011,26/06/2011,East And North Hertfordshire NHS Trust,2557,2975,2975,72,2903,0.97579831932773
26/06/2011,26/06/2011,Ipswich Hospital NHS Trust,1137,1137,1137,41,1096,0.96394019349164
26/06/2011,26/06/2011,Mid Essex Hospital Services NHS Trust,1432,1469,1469,81,1388,0.94486044928523
26/06/2011,26/06/2011,The Princess Alexandra Hospital NHS Trust,1691,1691,1691,104,1587,0.93849793021881
03/07/2011,03/07/2011,Cambridge University Hospitals NHS Foundation Trust,1914,1914,1914,44,1870,0.97701149425287
03/07/2011,03/07/2011,East And North Hertfordshire NHS Trust,2623,3046,3046,43,3003,0.98588312541037
03/07/2011,03/07/2011,Ipswich Hospital NHS Trust,1298,1298,1298,123,1175,0.90523882896764
03/07/2011,03/07/2011,Mid Essex Hospital Services NHS Trust,1439,1471,1471,47,1424,0.96804894629504
03/07/2011,03/07/2011,The Princess Alexandra Hospital NHS Trust,1621,1621,1621,73,1548,0.95496607032696
10/07/2011,10/07/2011,Cambridge University Hospitals NHS Foundation Trust,1924,1924,1924,51,1873,0.97349272349272
10/07/2011,10/07/2011,East And North Hertfordshire NHS Trust,2634,2970,2970,50,2920,0.98316498316498
10/07/2011,10/07/2011,Ipswich Hospital NHS Trust,1212,1212,1212,54,1158,0.95544554455446
10/07/2011,10/07/2011,Mid Essex Hospital Services NHS Trust,1500,1521,1521,127,1394,0.91650230111769
10/07/2011,10/07/2011,The Princess Alexandra Hospital NHS Trust,1651,1651,1651,65,1586,0.96062992125984
17/07/2011,17/07/2011,Cambridge University Hospitals NHS Foundation Trust,1836,1836,1836,53,1783,0.97113289760349
17/07/2011,17/07/2011,East And North Hertfordshire NHS Trust,2511,2893,2893,59,2834,0.97960594538541
17/07/2011,17/07/2011,Ipswich Hospital NHS Trust,1145,1145,1145,52,1093,0.95458515283843
17/07/2011,17/07/2011,Mid Essex Hospital Services NHS Trust,1490,1538,1538,96,1442,0.93758127438231
17/07/2011,17/07/2011,The Princess Alexandra Hospital NHS Trust,1551,1551,1551,48,1503,0.96905222437137
24/07/2011,24/07/2011,Cambridge University Hospitals NHS Foundation Trust,1017,1017,1017,30,987,0.97050147492625
24/07/2011,24/07/2011,East And North Hertfordshire NHS Trust,2520,2914,2914,61,2853,0.97906657515443
24/07/2011,24/07/2011,Ipswich Hospital NHS Trust,1253,1253,1253,54,1199,0.95690343176377
24/07/2011,24/07/2011,Mid Essex Hospital Services NHS Trust,1365,1401,1401,77,1324,0.94503925767309
24/07/2011,24/07/2011,The Princess Alexandra Hospital NHS Trust,1472,1472,1472,43,1429,0.97078804347826
31/07/2011,31/07/2011,Cambridge University Hospitals NHS Foundation Trust,1798,1798,1798,50,1748,0.97219132369299
31/07/2011,31/07/2011,East And North Hertfordshire NHS Trust,2504,2877,2877,35,2842,0.98783454987835
31/07/2011,31/07/2011,Ipswich Hospital NHS Trust,1162,1162,1162,22,1140,0.98106712564544
31/07/2011,31/07/2011,Mid Essex Hospital Services NHS Trust,1426,1452,1452,95,1357,0.93457300275482
31/07/2011,31/07/2011,The Princess Alexandra Hospital NHS Trust,1464,1464,1464,54,1410,0.96311475409836
07/08/2011,07/08/2011,Cambridge University Hospitals NHS Foundation Trust,1835,1835,1835,89,1746,0.95149863760218
07/08/2011,07/08/2011,East And North Hertfordshire NHS Trust,2443,2810,2810,70,2740,0.97508896797153
07/08/2011,07/08/2011,Ipswich Hospital NHS Trust,1143,1143,1143,12,1131,0.98950131233596
07/08/2011,07/08/2011,Mid Essex Hospital Services NHS Trust,1475,1494,1494,124,1370,0.91700133868809
07/08/2011,07/08/2011,The Princess Alexandra Hospital NHS Trust,1563,1563,1563,84,1479,0.94625719769674
14/08/2011,14/08/2011,Cambridge University Hospitals NHS Foundation Trust,1863,1863,1863,69,1794,0.96296296296296
14/08/2011,14/08/2011,East And North Hertfordshire NHS Trust,2322,2634,2634,59,2575,0.97760060744115
14/08/2011,14/08/2011,Ipswich Hospital NHS Trust,1188,1188,1188,19,1169,0.98400673400673
14/08/2011,14/08/2011,Mid Essex Hospital Services NHS Trust,1358,1379,1379,87,1292,0.93691080493111
14/08/2011,14/08/2011,The Princess Alexandra Hospital NHS Trust,1467,1467,1467,81,1386,0.94478527607362
21/08/2011,21/08/2011,Cambridge University Hospitals NHS Foundation Trust,1730,1730,1730,45,1685,0.97398843930636
21/08/2011,21/08/2011,East And North Hertfordshire NHS Trust,2271,2619,2619,55,2564,0.97899961817488
21/08/2011,21/08/2011,Ipswich Hospital NHS Trust,1162,1162,1162,21,1141,0.98192771084337
21/08/2011,21/08/2011,Mid Essex Hospital Services NHS Trust,1444,1470,1470,87,1383,0.94081632653061
21/08/2011,21/08/2011,The Princess Alexandra Hospital NHS Trust,1509,1509,1509,95,1414,0.93704440026508
28/08/2011,28/08/2011,Cambridge University Hospitals NHS Foundation Trust,1699,1699,1699,43,1656,0.97469099470277
28/08/2011,28/08/2011,East And North Hertfordshire NHS Trust,2315,2669,2669,39,2630,0.98538778568752
28/08/2011,28/08/2011,Ipswich Hospital NHS Trust,1120,1120,1120,17,1103,0.98482142857143
28/08/2011,28/08/2011,Mid Essex Hospital Services NHS Trust,1410,1433,1433,25,1408,0.98255408234473
28/08/2011,28/08/2011,The Princess Alexandra Hospital NHS Trust,1519,1519,1519,44,1475,0.97103357472021
04/09/2011,04/09/2011,Cambridge University Hospitals NHS Foundation Trust,1709,1709,1709,54,1655,0.96840257460503
04/09/2011,04/09/2011,East And North Hertfordshire NHS Trust,2444,2801,2801,85,2716,0.96965369510889
04/09/2011,04/09/2011,Ipswich Hospital NHS Trust,1214,1214,1214,15,1199,0.98764415156507
04/09/2011,04/09/2011,Mid Essex Hospital Services NHS Trust,1456,1483,1483,95,1388,0.93594066082266
04/09/2011,04/09/2011,The Princess Alexandra Hospital NHS Trust,1499,1499,1499,82,1417,0.94529686457638
11/09/2011,11/09/2011,Cambridge University Hospitals NHS Foundation Trust,1791,1791,1791,48,1743,0.97319932998325
11/09/2011,11/09/2011,East And North Hertfordshire NHS Trust,2423,2786,2786,155,2631,0.94436468054559
11/09/2011,11/09/2011,Ipswich Hospital NHS Trust,1168,1168,1168,22,1146,0.98116438356164
11/09/2011,11/09/2011,Mid Essex Hospital Services NHS Trust,1389,1418,1418,97,1321,0.93159379407616
11/09/2011,11/09/2011,The Princess Alexandra Hospital NHS Trust,1543,1543,1543,100,1443,0.9351911860013
18/09/2011,18/09/2011,Cambridge University Hospitals NHS Foundation Trust,1905,1905,1905,41,1864,0.97847769028871
18/09/2011,18/09/2011,East And North Hertfordshire NHS Trust,2538,2896,2896,30,2866,0.9896408839779
18/09/2011,18/09/2011,Ipswich Hospital NHS Trust,1211,1211,1211,13,1198,0.98926507018993
18/09/2011,18/09/2011,Mid Essex Hospital Services NHS Trust,1472,1497,1497,79,1418,0.94722778891116
18/09/2011,18/09/2011,The Princess Alexandra Hospital NHS Trust,1623,1623,1623,67,1556,0.95871842267406
25/09/2011,25/09/2011,Cambridge University Hospitals NHS Foundation Trust,2008,2008,2008,50,1958,0.97509960159363
25/09/2011,25/09/2011,East And North Hertfordshire NHS Trust,2602,2951,2951,122,2829,0.9586580820061
25/09/2011,25/09/2011,Ipswich Hospital NHS Trust,1262,1262,1262,19,1243,0.98494453248811
25/09/2011,25/09/2011,Mid Essex Hospital Services NHS Trust,1482,1527,1527,64,1463,0.95808775376555
25/09/2011,25/09/2011,The Princess Alexandra Hospital NHS Trust,1700,1700,1700,92,1608,0.94588235294118
02/10/2011,02/10/2011,Cambridge University Hospitals NHS Foundation Trust,2034,2034,2034,65,1969,0.96804326450344
02/10/2011,02/10/2011,East And North Hertfordshire NHS Trust,2621,2938,2938,140,2798,0.95234853641933
02/10/2011,02/10/2011,Ipswich Hospital NHS Trust,1243,1243,1243,23,1220,0.98149637972647
02/10/2011,02/10/2011,Mid Essex Hospital Services NHS Trust,1535,1573,1573,72,1501,0.95422759059123
02/10/2011,02/10/2011,The Princess Alexandra Hospital NHS Trust,1647,1647,1647,55,1592,0.96660595021251
09/10/2011,09/10/2011,Cambridge University Hospitals NHS Foundation Trust,2124,2124,2124,107,2017,0.94962335216573
09/10/2011,09/10/2011,East And North Hertfordshire NHS Trust,2667,2835,2835,148,2687,0.94779541446208
09/10/2011,09/10/2011,Ipswich Hospital NHS Trust,1218,1218,1218,25,1193,0.97947454844007
09/10/2011,09/10/2011,Mid Essex Hospital Services NHS Trust,1511,1553,1553,39,1514,0.97488731487444
09/10/2011,09/10/2011,The Princess Alexandra Hospital NHS Trust,1692,1692,1692,114,1578,0.93262411347518
16/10/2011,16/10/2011,Cambridge University Hospitals NHS Foundation Trust,1982,1982,1982,109,1873,0.94500504540868
16/10/2011,16/10/2011,East And North Hertfordshire NHS Trust,2617,2797,2797,144,2653,0.94851626742939
16/10/2011,16/10/2011,Ipswich Hospital NHS Trust,1156,1156,1156,27,1129,0.97664359861592
16/10/2011,16/10/2011,Mid Essex Hospital Services NHS Trust,1450,1489,1489,68,1421,0.9543317662861
16/10/2011,16/10/2011,The Princess Alexandra Hospital NHS Trust,1588,1588,1588,34,1554,0.97858942065491
23/10/2011,23/10/2011,Cambridge University Hospitals NHS Foundation Trust,1954,1954,1954,76,1878,0.9611054247697
23/10/2011,23/10/2011,East And North Hertfordshire NHS Trust,2368,2487,2487,101,2386,0.95938882187374
23/10/2011,23/10/2011,Ipswich Hospital NHS Trust,1167,1167,1167,24,1143,0.97943444730077
23/10/2011,23/10/2011,Mid Essex Hospital Services NHS Trust,1426,1473,1473,46,1427,0.96877121520706
23/10/2011,23/10/2011,The Princess Alexandra Hospital NHS Trust,1534,1534,1534,45,1489,0.97066492829205
30/10/2011,30/10/2011,Cambridge University Hospitals NHS Foundation Trust,1821,1821,1821,42,1779,0.97693574958814
30/10/2011,30/10/2011,East And North Hertfordshire NHS Trust,2385,2385,2385,242,2143,0.89853249475891
30/10/2011,30/10/2011,Ipswich Hospital NHS Trust,1130,1130,1130,35,1095,0.96902654867257
30/10/2011,30/10/2011,Mid Essex Hospital Services NHS Trust,1351,1394,1394,41,1353,0.97058823529412
30/10/2011,30/10/2011,The Princess Alexandra Hospital NHS Trust,1541,1541,1541,170,1371,0.88968202465931
06/11/2011,06/11/2011,Cambridge University Hospitals NHS Foundation Trust,1986,1986,1986,125,1861,0.93705941591138
06/11/2011,06/11/2011,East And North Hertfordshire NHS Trust,2678,2678,2678,145,2533,0.94585511575803
06/11/2011,06/11/2011,Ipswich Hospital NHS Trust,1194,1194,1194,34,1160,0.9715242881072
06/11/2011,06/11/2011,Mid Essex Hospital Services NHS Trust,1445,1487,1487,15,1472,0.98991257565568
06/11/2011,06/11/2011,The Princess Alexandra Hospital NHS Trust,1620,1620,1620,176,1444,0.89135802469136
13/11/2011,13/11/2011,Cambridge University Hospitals NHS Foundation Trust,1846,1846,1846,53,1793,0.97128927410618
13/11/2011,13/11/2011,East And North Hertfordshire NHS Trust,2554,2554,2554,156,2398,0.9389193422083
13/11/2011,13/11/2011,Ipswich Hospital NHS Trust,1169,1169,1169,22,1147,0.98118049615056
13/11/2011,13/11/2011,Mid Essex Hospital Services NHS Trust,1420,1447,1447,54,1393,0.96268140981341
13/11/2011,13/11/2011,The Princess Alexandra Hospital NHS Trust,1582,1582,1582,100,1482,0.93678887484197
20/11/2011,20/11/2011,Cambridge University Hospitals NHS Foundation Trust,1839,1839,1839,100,1739,0.94562262098967
20/11/2011,20/11/2011,East And North Hertfordshire NHS Trust,2537,2537,2537,97,2440,0.96176586519511
20/11/2011,20/11/2011,Ipswich Hospital NHS Trust,1073,1073,1073,39,1034,0.96365330848089
20/11/2011,20/11/2011,Mid Essex Hospital Services NHS Trust,1377,1415,1415,48,1367,0.9660777385159
20/11/2011,20/11/2011,The Princess Alexandra Hospital NHS Trust,1605,1605,1605,159,1446,0.90093457943925
27/11/2011,27/11/2011,Cambridge University Hospitals NHS Foundation Trust,1880,1880,1880,88,1792,0.9531914893617
27/11/2011,27/11/2011,East And North Hertfordshire NHS Trust,2494,2494,2494,63,2431,0.9747393744988
27/11/2011,27/11/2011,Ipswich Hospital NHS Trust,1189,1189,1189,63,1126,0.94701429772918
27/11/2011,27/11/2011,Mid Essex Hospital Services NHS Trust,1417,1477,1477,50,1427,0.96614759647935
27/11/2011,27/11/2011,The Princess Alexandra Hospital NHS Trust,1619,1619,1619,246,1373,0.84805435453984
04/12/2011,04/12/2011,Cambridge University Hospitals NHS Foundation Trust,1816,1816,1816,118,1698,0.93502202643172
04/12/2011,04/12/2011,East And North Hertfordshire NHS Trust,2507,2507,2507,195,2312,0.92221779018748
04/12/2011,04/12/2011,Ipswich Hospital NHS Trust,1099,1099,1099,50,1049,0.95450409463148
04/12/2011,04/12/2011,Mid Essex Hospital Services NHS Trust,1457,1511,1511,76,1435,0.94970218398412
04/12/2011,04/12/2011,The Princess Alexandra Hospital NHS Trust,1580,1580,1580,174,1406,0.88987341772152
11/12/2011,11/12/2011,Cambridge University Hospitals NHS Foundation Trust,1810,1810,1810,173,1637,0.90441988950276
11/12/2011,11/12/2011,East And North Hertfordshire NHS Trust,2438,2438,2438,207,2231,0.91509433962264
11/12/2011,11/12/2011,Ipswich Hospital NHS Trust,1195,1195,1195,84,1111,0.92970711297071
11/12/2011,11/12/2011,Mid Essex Hospital Services NHS Trust,1388,1427,1427,59,1368,0.95865451997197
11/12/2011,11/12/2011,The Princess Alexandra Hospital NHS Trust,1632,1632,1632,227,1405,0.8609068627451
18/12/2011,18/12/2011,Cambridge University Hospitals NHS Foundation Trust,1812,1812,1812,113,1699,0.93763796909492
18/12/2011,18/12/2011,East And North Hertfordshire NHS Trust,2384,2384,2384,118,2266,0.9505033557047
18/12/2011,18/12/2011,Ipswich Hospital NHS Trust,1136,1136,1136,57,1079,0.94982394366197
18/12/2011,18/12/2011,Mid Essex Hospital Services NHS Trust,1388,1423,1423,69,1354,0.95151089248067
18/12/2011,18/12/2011,The Princess Alexandra Hospital NHS Trust,1615,1615,1615,238,1377,0.85263157894737
25/12/2011,25/12/2011,Cambridge University Hospitals NHS Foundation Trust,1616,1616,1616,52,1564,0.96782178217822
25/12/2011,25/12/2011,East And North Hertfordshire NHS Trust,2189,2189,2189,172,2017,0.92142530835998
25/12/2011,25/12/2011,Ipswich Hospital NHS Trust,1083,1083,1083,60,1023,0.94459833795014
25/12/2011,25/12/2011,Mid Essex Hospital Services NHS Trust,1266,1303,1303,9,1294,0.99309286262471
25/12/2011,25/12/2011,The Princess Alexandra Hospital NHS Trust,1521,1521,1521,176,1345,0.88428665351742
01/01/2012,01/01/2012,Cambridge University Hospitals NHS Foundation Trust,1781,1781,1781,47,1734,0.97361033127456
01/01/2012,01/01/2012,East And North Hertfordshire NHS Trust,2254,2254,2254,159,2095,0.92945874001775
01/01/2012,01/01/2012,Ipswich Hospital NHS Trust,1295,1295,1295,64,1231,0.95057915057915
01/01/2012,01/01/2012,Mid Essex Hospital Services NHS Trust,1430,1458,1458,21,1437,0.98559670781893
01/01/2012,01/01/2012,The Princess Alexandra Hospital NHS Trust,1396,1396,1396,292,1104,0.79083094555874
08/01/2012,08/01/2012,Cambridge University Hospitals NHS Foundation Trust,1820,1820,1820,170,1650,0.90659340659341
08/01/2012,08/01/2012,East And North Hertfordshire NHS Trust,2341,2341,2341,254,2087,0.89149935924818
08/01/2012,08/01/2012,Ipswich Hospital NHS Trust,1253,1253,1253,110,1143,0.9122106943336
08/01/2012,08/01/2012,Mid Essex Hospital Services NHS Trust,1428,1460,1460,77,1383,0.9472602739726
08/01/2012,08/01/2012,The Princess Alexandra Hospital NHS Trust,1481,1481,1481,500,981,0.66239027683997
15/01/2012,15/01/2012,Cambridge University Hospitals NHS Foundation Trust,1800,1800,1800,85,1715,0.95277777777778
15/01/2012,15/01/2012,East And North Hertfordshire NHS Trust,2224,2224,2224,167,2057,0.92491007194245
15/01/2012,15/01/2012,Ipswich Hospital NHS Trust,1069,1069,1069,30,1039,0.97193638914874
15/01/2012,15/01/2012,Mid Essex Hospital Services NHS Trust,1327,1362,1362,25,1337,0.98164464023495
15/01/2012,15/01/2012,The Princess Alexandra Hospital NHS Trust,1499,1499,1499,360,1139,0.75983989326217
22/01/2012,22/01/2012,Cambridge University Hospitals NHS Foundation Trust,1742,1742,1742,118,1624,0.93226176808266
22/01/2012,22/01/2012,East And North Hertfordshire NHS Trust,2245,2245,2245,102,2143,0.95456570155902
22/01/2012,22/01/2012,Ipswich Hospital NHS Trust,1123,1123,1123,45,1078,0.95992876224399
22/01/2012,22/01/2012,Mid Essex Hospital Services NHS Trust,1393,1423,1423,37,1386,0.97399859451862
22/01/2012,22/01/2012,The Princess Alexandra Hospital NHS Trust,1378,1378,1378,228,1150,0.83454281567489
29/01/2012,29/01/2012,Cambridge University Hospitals NHS Foundation Trust,1903,1903,1903,85,1818,0.95533368365738
29/01/2012,29/01/2012,East And North Hertfordshire NHS Trust,2348,2348,2348,154,2194,0.93441226575809
29/01/2012,29/01/2012,Ipswich Hospital NHS Trust,1192,1192,1192,34,1158,0.97147651006711
29/01/2012,29/01/2012,Mid Essex Hospital Services NHS Trust,1459,1489,1489,37,1452,0.97515110812626
29/01/2012,29/01/2012,The Princess Alexandra Hospital NHS Trust,1478,1478,1478,199,1279,0.86535859269283
05/02/2012,05/02/2012,Cambridge University Hospitals NHS Foundation Trust,1689,1689,1689,117,1572,0.93072824156306
05/02/2012,05/02/2012,East And North Hertfordshire NHS Trust,2175,2175,2175,89,2086,0.95908045977011
05/02/2012,05/02/2012,Ipswich Hospital NHS Trust,1165,1165,1165,31,1134,0.97339055793991
05/02/2012,05/02/2012,Mid Essex Hospital Services NHS Trust,1306,1344,1344,32,1312,0.97619047619048
05/02/2012,05/02/2012,The Princess Alexandra Hospital NHS Trust,1471,1471,1471,193,1278,0.86879673691366
12/02/2012,12/02/2012,Cambridge University Hospitals NHS Foundation Trust,1837,1837,1837,169,1668,0.90800217746326
12/02/2012,12/02/2012,East And North Hertfordshire NHS Trust,2251,2251,2251,90,2161,0.96001776988005
12/02/2012,12/02/2012,Ipswich Hospital NHS Trust,1242,1242,1242,81,1161,0.93478260869565
12/02/2012,12/02/2012,Mid Essex Hospital Services NHS Trust,1484,1534,1534,47,1487,0.96936114732725
12/02/2012,12/02/2012,The Princess Alexandra Hospital NHS Trust,1439,1439,1439,201,1238,0.86031966643502
19/02/2012,19/02/2012,Cambridge University Hospitals NHS Foundation Trust,1783,1783,1783,169,1614,0.90521592821088
19/02/2012,19/02/2012,East And North Hertfordshire NHS Trust,2386,2386,2386,67,2319,0.97191953059514
19/02/2012,19/02/2012,Ipswich Hospital NHS Trust,1156,1156,1156,65,1091,0.94377162629758
19/02/2012,19/02/2012,Mid Essex Hospital Services NHS Trust,1437,1475,1475,59,1416,0.96
19/02/2012,19/02/2012,The Princess Alexandra Hospital NHS Trust,1494,1494,1494,358,1136,0.76037483266399
26/02/2012,26/02/2012,Cambridge University Hospitals NHS Foundation Trust,1948,1948,1948,183,1765,0.90605749486653
26/02/2012,26/02/2012,East And North Hertfordshire NHS Trust,2571,2571,2571,151,2420,0.9412679891093
26/02/2012,26/02/2012,Ipswich Hospital NHS Trust,1193,1193,1193,99,1094,0.91701592623638
26/02/2012,26/02/2012,Mid Essex Hospital Services NHS Trust,1545,1599,1599,59,1540,0.96310193871169
26/02/2012,26/02/2012,The Princess Alexandra Hospital NHS Trust,1569,1569,1569,315,1254,0.79923518164436
04/03/2012,04/03/2012,Cambridge University Hospitals NHS Foundation Trust,1855,1855,1855,74,1781,0.96010781671159
04/03/2012,04/03/2012,East And North Hertfordshire NHS Trust,2479,2479,2479,117,2362,0.95280354981848
04/03/2012,04/03/2012,Ipswich Hospital NHS Trust,1261,1261,1261,96,1165,0.9238699444885
04/03/2012,04/03/2012,Mid Essex Hospital Services NHS Trust,1536,1577,1577,102,1475,0.93532022828155
04/03/2012,04/03/2012,The Princess Alexandra Hospital NHS Trust,1641,1641,1641,288,1353,0.82449725776965
11/03/2012,11/03/2012,Cambridge University Hospitals NHS Foundation Trust,2007,2007,2007,227,1780,0.88689586447434
11/03/2012,11/03/2012,East And North Hertfordshire NHS Trust,2532,2532,2532,62,2470,0.97551342812006
11/03/2012,11/03/2012,Ipswich Hospital NHS Trust,1249,1249,1249,23,1226,0.98158526821457
11/03/2012,11/03/2012,Mid Essex Hospital Services NHS Trust,1517,1550,1550,20,1530,0.98709677419355
11/03/2012,11/03/2012,The Princess Alexandra Hospital NHS Trust,1483,1483,1483,70,1413,0.9527983816588
18/03/2012,18/03/2012,Cambridge University Hospitals NHS Foundation Trust,1928,1928,1928,137,1791,0.92894190871369
18/03/2012,18/03/2012,East And North Hertfordshire NHS Trust,2494,2494,2494,93,2401,0.96271050521251
18/03/2012,18/03/2012,Ipswich Hospital NHS Trust,1326,1326,1326,67,1259,0.94947209653092
18/03/2012,18/03/2012,Mid Essex Hospital Services NHS Trust,1456,1497,1497,17,1480,0.98864395457582
18/03/2012,18/03/2012,The Princess Alexandra Hospital NHS Trust,1547,1547,1547,151,1396,0.90239172592114
25/03/2012,25/03/2012,Cambridge University Hospitals NHS Foundation Trust,1957,1957,1957,225,1732,0.88502810424119
25/03/2012,25/03/2012,East And North Hertfordshire NHS Trust,2538,2538,2538,67,2471,0.9736012608353
25/03/2012,25/03/2012,Ipswich Hospital NHS Trust,1349,1349,1349,10,1339,0.99258710155671
25/03/2012,25/03/2012,Mid Essex Hospital Services NHS Trust,1618,1677,1677,37,1640,0.97793679189028
25/03/2012,25/03/2012,The Princess Alexandra Hospital NHS Trust,1626,1626,1626,114,1512,0.92988929889299
01/04/2012,01/04/2012,Cambridge University Hospitals NHS Foundation Trust,1873,1873,1873,165,1708,0.91190603310198
01/04/2012,01/04/2012,East And North Hertfordshire NHS Trust,2600,2600,2600,50,2550,0.98076923076923
01/04/2012,01/04/2012,Ipswich Hospital NHS Trust,1450,1450,1450,3,1447,0.99793103448276
01/04/2012,01/04/2012,Mid Essex Hospital Services NHS Trust,1545,1586,1586,14,1572,0.99117276166456
01/04/2012,01/04/2012,The Princess Alexandra Hospital NHS Trust,1626,1626,1626,185,1441,0.88622386223862
08/04/2012,08/04/2012,Cambridge University Hospitals NHS Foundation Trust,1758,1758,1758,92,1666,0.94766780432309
08/04/2012,08/04/2012,East And North Hertfordshire NHS Trust,2449,2449,2449,39,2410,0.98407513270723
08/04/2012,08/04/2012,Ipswich Hospital NHS Trust,1340,1340,1340,31,1309,0.97686567164179
08/04/2012,08/04/2012,Mid Essex Hospital Services NHS Trust,1442,1475,1475,12,1463,0.99186440677966
08/04/2012,08/04/2012,The Princess Alexandra Hospital NHS Trust,1448,1448,1448,59,1389,0.95925414364641
15/04/2012,15/04/2012,Cambridge University Hospitals NHS Foundation Trust,1832,1832,1832,307,1525,0.83242358078603
15/04/2012,15/04/2012,East And North Hertfordshire NHS Trust,2353,2353,2353,55,2298,0.97662558436039
15/04/2012,15/04/2012,Ipswich Hospital NHS Trust,1278,1278,1278,46,1232,0.96400625978091
15/04/2012,15/04/2012,Mid Essex Hospital Services NHS Trust,1482,1505,1505,123,1382,0.91827242524917
15/04/2012,15/04/2012,The Princess Alexandra Hospital NHS Trust,1490,1490,1490,54,1436,0.96375838926174
22/04/2012,22/04/2012,Cambridge University Hospitals NHS Foundation Trust,1798,1798,1798,194,1604,0.89210233592881
22/04/2012,22/04/2012,East And North Hertfordshire NHS Trust,2398,2398,2398,95,2303,0.9603836530442
22/04/2012,22/04/2012,Ipswich Hospital NHS Trust,1199,1199,1199,28,1171,0.976647206005
22/04/2012,22/04/2012,Mid Essex Hospital Services NHS Trust,1488,1515,1515,47,1468,0.96897689768977
22/04/2012,22/04/2012,The Princess Alexandra Hospital NHS Trust,1546,1546,1546,52,1494,0.96636481241915
29/04/2012,29/04/2012,Cambridge University Hospitals NHS Foundation Trust,1790,1790,1790,159,1631,0.91117318435754
29/04/2012,29/04/2012,East And North Hertfordshire NHS Trust,2352,2352,2352,23,2329,0.99022108843537
29/04/2012,29/04/2012,Ipswich Hospital NHS Trust,1158,1158,1158,27,1131,0.97668393782383
29/04/2012,29/04/2012,Mid Essex Hospital Services NHS Trust,1404,1439,1439,46,1393,0.96803335649757
29/04/2012,29/04/2012,The Princess Alexandra Hospital NHS Trust,1536,1536,1536,76,1460,0.95052083333333
06/05/2012,06/05/2012,Cambridge University Hospitals NHS Foundation Trust,1863,1863,1863,115,1748,0.93827160493827
06/05/2012,06/05/2012,East And North Hertfordshire NHS Trust,2318,2318,2318,90,2228,0.9611734253667
06/05/2012,06/05/2012,Ipswich Hospital NHS Trust,1229,1229,1229,7,1222,0.99430431244915
06/05/2012,06/05/2012,Mid Essex Hospital Services NHS Trust,1540,1575,1575,38,1537,0.97587301587302
06/05/2012,06/05/2012,The Princess Alexandra Hospital NHS Trust,1563,1563,1563,60,1503,0.9616122840691
13/05/2012,13/05/2012,Cambridge University Hospitals NHS Foundation Trust,1926,1926,1926,106,1820,0.94496365524403
13/05/2012,13/05/2012,East And North Hertfordshire NHS Trust,2430,2430,2430,63,2367,0.97407407407407
13/05/2012,13/05/2012,Ipswich Hospital NHS Trust,1326,1326,1326,35,1291,0.973604826546
13/05/2012,13/05/2012,Mid Essex Hospital Services NHS Trust,1542,1560,1560,58,1502,0.96282051282051
13/05/2012,13/05/2012,The Princess Alexandra Hospital NHS Trust,1561,1561,1561,76,1485,0.9513132607303
20/05/2012,20/05/2012,Cambridge University Hospitals NHS Foundation Trust,1868,1868,1868,184,1684,0.90149892933619
20/05/2012,20/05/2012,East And North Hertfordshire NHS Trust,2460,2460,2460,58,2402,0.97642276422764
20/05/2012,20/05/2012,Ipswich Hospital NHS Trust,1232,1232,1232,18,1214,0.98538961038961
20/05/2012,20/05/2012,Mid Essex Hospital Services NHS Trust,1531,1557,1557,26,1531,0.98330122029544
20/05/2012,20/05/2012,The Princess Alexandra Hospital NHS Trust,1496,1496,1496,97,1399,0.93516042780749
27/05/2012,27/05/2012,Cambridge University Hospitals NHS Foundation Trust,1981,1981,1981,95,1886,0.95204442200909
27/05/2012,27/05/2012,East And North Hertfordshire NHS Trust,2584,2584,2584,44,2540,0.98297213622291
27/05/2012,27/05/2012,Ipswich Hospital NHS Trust,1208,1208,1208,21,1187,0.98261589403974
27/05/2012,27/05/2012,Mid Essex Hospital Services NHS Trust,1584,1626,1626,63,1563,0.96125461254613
27/05/2012,27/05/2012,The Princess Alexandra Hospital NHS Trust,1590,1590,1590,84,1506,0.94716981132075
03/06/2012,03/06/2012,Cambridge University Hospitals NHS Foundation Trust,2018,2018,2018,114,1904,0.94350842418236
03/06/2012,03/06/2012,East And North Hertfordshire NHS Trust,2639,2639,2639,91,2548,0.96551724137931
03/06/2012,03/06/2012,Ipswich Hospital NHS Trust,1349,1349,1349,46,1303,0.96590066716086
03/06/2012,03/06/2012,Mid Essex Hospital Services NHS Trust,1659,1686,1686,44,1642,0.97390272835113
03/06/2012,03/06/2012,The Princess Alexandra Hospital NHS Trust,1733,1733,1733,91,1642,0.94748990190421
10/06/2012,10/06/2012,Cambridge University Hospitals NHS Foundation Trust,1881,1881,1881,173,1708,0.90802764486975
10/06/2012,10/06/2012,East And North Hertfordshire NHS Trust,2423,2423,2423,30,2393,0.98761865456046
10/06/2012,10/06/2012,Ipswich Hospital NHS Trust,1414,1414,1414,65,1349,0.95403111739745
10/06/2012,10/06/2012,Mid Essex Hospital Services NHS Trust,1538,1564,1564,27,1537,0.98273657289003
10/06/2012,10/06/2012,The Princess Alexandra Hospital NHS Trust,1592,1592,1592,73,1519,0.95414572864322
17/06/2012,17/06/2012,Cambridge University Hospitals NHS Foundation Trust,1874,1874,1874,81,1793,0.95677694770544
17/06/2012,17/06/2012,East And North Hertfordshire NHS Trust,2404,2404,2404,65,2339,0.97296173044925
17/06/2012,17/06/2012,Ipswich Hospital NHS Trust,1371,1371,1371,48,1323,0.96498905908096
17/06/2012,17/06/2012,Mid Essex Hospital Services NHS Trust,1549,1576,1576,49,1527,0.96890862944162
17/06/2012,17/06/2012,The Princess Alexandra Hospital NHS Trust,1622,1622,1622,108,1514,0.93341553637485
24/06/2012,24/06/2012,Cambridge University Hospitals NHS Foundation Trust,1951,1951,1951,83,1868,0.95745771399282
24/06/2012,24/06/2012,East And North Hertfordshire NHS Trust,2559,2559,2559,118,2441,0.95388823759281
24/06/2012,24/06/2012,Ipswich Hospital NHS Trust,1326,1326,1326,56,1270,0.9577677224736
24/06/2012,24/06/2012,Mid Essex Hospital Services NHS Trust,1540,1572,1572,57,1515,0.96374045801527
24/06/2012,24/06/2012,The Princess Alexandra Hospital NHS Trust,1715,1715,1715,119,1596,0.93061224489796
01/07/2012,01/07/2012,Cambridge University Hospitals NHS Foundation Trust,1982,1982,1982,150,1832,0.92431886982846
01/07/2012,01/07/2012,East And North Hertfordshire NHS Trust,2630,2630,2630,65,2565,0.97528517110266
01/07/2012,01/07/2012,Ipswich Hospital NHS Trust,1478,1478,1478,62,1416,0.95805142083897
01/07/2012,01/07/2012,Mid Essex Hospital Services NHS Trust,1546,1583,1583,39,1544,0.97536323436513
01/07/2012,01/07/2012,The Princess Alexandra Hospital NHS Trust,1776,1776,1776,108,1668,0.93918918918919
08/07/2012,08/07/2012,Cambridge University Hospitals NHS Foundation Trust,1895,1895,1895,187,1708,0.90131926121372
08/07/2012,08/07/2012,East And North Hertfordshire NHS Trust,2544,2544,2544,41,2503,0.98388364779874
08/07/2012,08/07/2012,Ipswich Hospital NHS Trust,1659,1659,1659,85,1574,0.94876431585292
08/07/2012,08/07/2012,Mid Essex Hospital Services NHS Trust,1600,1626,1626,57,1569,0.96494464944649
08/07/2012,08/07/2012,The Princess Alexandra Hospital NHS Trust,1645,1645,1645,152,1493,0.90759878419453
15/07/2012,15/07/2012,Cambridge University Hospitals NHS Foundation Trust,1896,1896,1896,156,1740,0.91772151898734
15/07/2012,15/07/2012,East And North Hertfordshire NHS Trust,2625,2625,2625,75,2550,0.97142857142857
15/07/2012,15/07/2012,Ipswich Hospital NHS Trust,1546,1546,1546,37,1509,0.97606727037516
15/07/2012,15/07/2012,Mid Essex Hospital Services NHS Trust,1521,1561,1561,150,1411,0.90390775144138
15/07/2012,15/07/2012,The Princess Alexandra Hospital NHS Trust,1670,1670,1670,91,1579,0.94550898203593
22/07/2012,22/07/2012,Cambridge University Hospitals NHS Foundation Trust,1941,1941,1941,139,1802,0.92838742916023
22/07/2012,22/07/2012,East And North Hertfordshire NHS Trust,2375,2375,2375,46,2329,0.98063157894737
22/07/2012,22/07/2012,Ipswich Hospital NHS Trust,1551,1551,1551,77,1474,0.95035460992908
22/07/2012,22/07/2012,Mid Essex Hospital Services NHS Trust,1571,1592,1592,96,1496,0.93969849246231
22/07/2012,22/07/2012,The Princess Alexandra Hospital NHS Trust,1551,1551,1551,55,1496,0.9645390070922
29/07/2012,29/07/2012,Cambridge University Hospitals NHS Foundation Trust,1869,1869,1869,90,1779,0.95184590690209
29/07/2012,29/07/2012,East And North Hertfordshire NHS Trust,2337,2337,2337,42,2295,0.98202824133504
29/07/2012,29/07/2012,Ipswich Hospital NHS Trust,1521,1521,1521,52,1469,0.96581196581197
29/07/2012,29/07/2012,Mid Essex Hospital Services NHS Trust,1575,1612,1612,113,1499,0.92990074441687
29/07/2012,29/07/2012,The Princess Alexandra Hospital NHS Trust,1603,1603,1603,76,1527,0.95258889582034
05/08/2012,05/08/2012,Cambridge University Hospitals NHS Foundation Trust,1793,1793,1793,103,1690,0.9425543781372
05/08/2012,05/08/2012,East And North Hertfordshire NHS Trust,2267,2267,2267,47,2220,0.97926775474195
05/08/2012,05/08/2012,Ipswich Hospital NHS Trust,1461,1461,1461,40,1421,0.97262149212868
05/08/2012,05/08/2012,Mid Essex Hospital Services NHS Trust,1482,1511,1511,73,1438,0.95168762409001
05/08/2012,05/08/2012,The Princess Alexandra Hospital NHS Trust,1514,1514,1514,185,1329,0.8778071334214
12/08/2012,12/08/2012,Cambridge University Hospitals NHS Foundation Trust,1756,1756,1756,31,1725,0.98234624145786
12/08/2012,12/08/2012,East And North Hertfordshire NHS Trust,2260,2260,2260,58,2202,0.97433628318584
12/08/2012,12/08/2012,Ipswich Hospital NHS Trust,1525,1525,1525,68,1457,0.95540983606557
12/08/2012,12/08/2012,Mid Essex Hospital Services NHS Trust,1438,1461,1461,13,1448,0.99110198494182
12/08/2012,12/08/2012,The Princess Alexandra Hospital NHS Trust,1519,1519,1519,42,1477,0.97235023041475
19/08/2012,19/08/2012,Cambridge University Hospitals NHS Foundation Trust,1863,1863,1863,84,1779,0.9549114331723
19/08/2012,19/08/2012,East And North Hertfordshire NHS Trust,2402,2402,2402,93,2309,0.96128226477935
19/08/2012,19/08/2012,Ipswich Hospital NHS Trust,1638,1638,1638,125,1513,0.92368742368742
19/08/2012,19/08/2012,Mid Essex Hospital Services NHS Trust,1599,1614,1614,81,1533,0.94981412639405
19/08/2012,19/08/2012,The Princess Alexandra Hospital NHS Trust,1520,1520,1520,66,1454,0.95657894736842
26/08/2012,26/08/2012,Cambridge University Hospitals NHS Foundation Trust,1824,1824,1824,17,1807,0.9906798245614
26/08/2012,26/08/2012,East And North Hertfordshire NHS Trust,2317,2317,2317,49,2268,0.97885196374622
26/08/2012,26/08/2012,Ipswich Hospital NHS Trust,1552,1552,1552,75,1477,0.95167525773196
26/08/2012,26/08/2012,Mid Essex Hospital Services NHS Trust,1584,1607,1607,25,1582,0.98444306160548
26/08/2012,26/08/2012,The Princess Alexandra Hospital NHS Trust,1628,1628,1628,77,1551,0.9527027027027
02/09/2012,02/09/2012,Cambridge University Hospitals NHS Foundation Trust,1865,1865,1865,15,1850,0.99195710455764
02/09/2012,02/09/2012,East And North Hertfordshire NHS Trust,2243,2243,2243,33,2210,0.98528756130183
02/09/2012,02/09/2012,Ipswich Hospital NHS Trust,1501,1501,1501,101,1400,0.93271152564957
02/09/2012,02/09/2012,Mid Essex Hospital Services NHS Trust,1441,1471,1471,62,1409,0.95785180149558
02/09/2012,02/09/2012,The Princess Alexandra Hospital NHS Trust,1505,1505,1505,84,1421,0.94418604651163
09/09/2012,09/09/2012,Cambridge University Hospitals NHS Foundation Trust,1795,1795,1795,18,1777,0.9899721448468
09/09/2012,09/09/2012,East And North Hertfordshire NHS Trust,2348,2348,2348,61,2287,0.97402044293015
09/09/2012,09/09/2012,Ipswich Hospital NHS Trust,1464,1464,1464,114,1350,0.92213114754098
09/09/2012,09/09/2012,Mid Essex Hospital Services NHS Trust,1463,1490,1490,28,1462,0.98120805369128
09/09/2012,09/09/2012,The Princess Alexandra Hospital NHS Trust,1556,1556,1556,123,1433,0.92095115681234
16/09/2012,16/09/2012,Cambridge University Hospitals NHS Foundation Trust,1903,1903,1903,57,1846,0.97004729374672
16/09/2012,16/09/2012,East And North Hertfordshire NHS Trust,2428,2428,2428,75,2353,0.96911037891269
16/09/2012,16/09/2012,Ipswich Hospital NHS Trust,1524,1524,1524,138,1386,0.90944881889764
16/09/2012,16/09/2012,Mid Essex Hospital Services NHS Trust,1594,1617,1617,29,1588,0.98206555349412
16/09/2012,16/09/2012,The Princess Alexandra Hospital NHS Trust,1841,1841,1841,123,1718,0.93318848451928
23/09/2012,23/09/2012,Cambridge University Hospitals NHS Foundation Trust,1894,1894,1894,43,1851,0.97729672650475
23/09/2012,23/09/2012,East And North Hertfordshire NHS Trust,2362,2362,2362,132,2230,0.94411515664691
23/09/2012,23/09/2012,Ipswich Hospital NHS Trust,1538,1538,1538,35,1503,0.97724317295189
23/09/2012,23/09/2012,Mid Essex Hospital Services NHS Trust,1577,1597,1597,58,1539,0.96368190356919
23/09/2012,23/09/2012,The Princess Alexandra Hospital NHS Trust,1817,1817,1817,143,1674,0.92129884424876
30/09/2012,30/09/2012,Cambridge University Hospitals NHS Foundation Trust,1903,1903,1903,34,1869,0.98213347346295
30/09/2012,30/09/2012,East And North Hertfordshire NHS Trust,2525,2525,2525,172,2353,0.93188118811881
30/09/2012,30/09/2012,Ipswich Hospital NHS Trust,1488,1488,1488,4,1484,0.99731182795699
30/09/2012,30/09/2012,Mid Essex Hospital Services NHS Trust,1525,1551,1551,73,1478,0.95293359123146
30/09/2012,30/09/2012,The Princess Alexandra Hospital NHS Trust,1722,1722,1722,73,1649,0.95760743321719
07/10/2012,07/10/2012,Cambridge University Hospitals NHS Foundation Trust,2044,2044,2044,123,1921,0.93982387475538
07/10/2012,07/10/2012,East And North Hertfordshire NHS Trust,2473,2473,2473,63,2410,0.97452486858067
07/10/2012,07/10/2012,Ipswich Hospital NHS Trust,1490,1490,1490,48,1442,0.96778523489933
07/10/2012,07/10/2012,Mid Essex Hospital Services NHS Trust,1475,1502,1502,68,1434,0.95472703062583
07/10/2012,07/10/2012,The Princess Alexandra Hospital NHS Trust,1633,1633,1633,66,1567,0.95958358848745
14/10/2012,14/10/2012,Cambridge University Hospitals NHS Foundation Trust,1922,1922,1922,62,1860,0.96774193548387
14/10/2012,14/10/2012,East And North Hertfordshire NHS Trust,2427,2427,2427,44,2383,0.98187062216728
14/10/2012,14/10/2012,Ipswich Hospital NHS Trust,1498,1498,1498,32,1466,0.97863818424566
14/10/2012,14/10/2012,Mid Essex Hospital Services NHS Trust,1466,1509,1509,36,1473,0.97614314115308
14/10/2012,14/10/2012,The Princess Alexandra Hospital NHS Trust,1670,1670,1670,97,1573,0.94191616766467
21/10/2012,21/10/2012,Cambridge University Hospitals NHS Foundation Trust,1967,1967,1967,78,1889,0.96034570411795
21/10/2012,21/10/2012,East And North Hertfordshire NHS Trust,2479,2479,2479,119,2360,0.9519967728923
21/10/2012,21/10/2012,Ipswich Hospital NHS Trust,1568,1568,1568,60,1508,0.96173469387755
21/10/2012,21/10/2012,Mid Essex Hospital Services NHS Trust,1508,1545,1545,105,1440,0.93203883495146
21/10/2012,21/10/2012,The Princess Alexandra Hospital NHS Trust,1720,1720,1720,181,1539,0.89476744186046
28/10/2012,28/10/2012,Cambridge University Hospitals NHS Foundation Trust,1868,1868,1868,41,1827,0.97805139186295
28/10/2012,28/10/2012,East And North Hertfordshire NHS Trust,2402,2402,2402,88,2314,0.96336386344713
28/10/2012,28/10/2012,Ipswich Hospital NHS Trust,1400,1400,1400,42,1358,0.97
28/10/2012,28/10/2012,Mid Essex Hospital Services NHS Trust,1485,1535,1535,66,1469,0.95700325732899
28/10/2012,28/10/2012,The Princess Alexandra Hospital NHS Trust,1658,1658,1658,104,1554,0.9372738238842
04/11/2012,04/11/2012,Cambridge University Hospitals NHS Foundation Trust,1579,1579,1579,53,1526,0.96643445218493
04/11/2012,04/11/2012,East And North Hertfordshire NHS Trust,2297,2297,2297,107,2190,0.95341750108838
04/11/2012,04/11/2012,Ipswich Hospital NHS Trust,1304,1304,1304,15,1289,0.98849693251534
04/11/2012,04/11/2012,Mid Essex Hospital Services NHS Trust,1398,1430,1430,14,1416,0.99020979020979
04/11/2012,04/11/2012,The Princess Alexandra Hospital NHS Trust,1611,1794,1794,73,1721,0.95930880713489
11/11/2012,11/11/2012,Cambridge University Hospitals NHS Foundation Trust,1915,1915,1915,98,1817,0.94882506527415
11/11/2012,11/11/2012,East And North Hertfordshire NHS Trust,2471,2471,2471,123,2348,0.95022258195063
11/11/2012,11/11/2012,Ipswich Hospital NHS Trust,1401,1401,1401,56,1345,0.96002855103497
11/11/2012,11/11/2012,Mid Essex Hospital Services NHS Trust,1464,1518,1518,41,1477,0.9729907773386
11/11/2012,11/11/2012,The Princess Alexandra Hospital NHS Trust,1899,2145,2145,136,2009,0.93659673659674
18/11/2012,18/11/2012,Cambridge University Hospitals NHS Foundation Trust,1938,1938,1938,62,1876,0.96800825593395
18/11/2012,18/11/2012,East And North Hertfordshire NHS Trust,2447,2447,2447,99,2348,0.95954229668982
18/11/2012,18/11/2012,Ipswich Hospital NHS Trust,1435,1435,1435,90,1345,0.93728222996516
18/11/2012,18/11/2012,Mid Essex Hospital Services NHS Trust,1510,1543,1543,56,1487,0.96370706416073
18/11/2012,18/11/2012,The Princess Alexandra Hospital NHS Trust,1786,2057,2057,99,1958,0.95187165775401
25/11/2012,25/11/2012,Cambridge University Hospitals NHS Foundation Trust,1914,1914,1914,65,1849,0.96603970741902
25/11/2012,25/11/2012,East And North Hertfordshire NHS Trust,2511,2511,2511,108,2403,0.95698924731183
25/11/2012,25/11/2012,Ipswich Hospital NHS Trust,1427,1427,1427,97,1330,0.93202522775053
25/11/2012,25/11/2012,Mid Essex Hospital Services NHS Trust,1483,1540,1540,39,1501,0.97467532467532
25/11/2012,25/11/2012,The Princess Alexandra Hospital NHS Trust,1787,2062,2062,87,1975,0.95780795344326
02/12/2012,02/12/2012,Cambridge University Hospitals NHS Foundation Trust,1953,1953,1953,50,1903,0.97439836149514
02/12/2012,02/12/2012,East And North Hertfordshire NHS Trust,2353,2353,2353,138,2215,0.94135146621334
02/12/2012,02/12/2012,Ipswich Hospital NHS Trust,1431,1431,1431,54,1377,0.9622641509434
02/12/2012,02/12/2012,Mid Essex Hospital Services NHS Trust,1433,1482,1482,62,1420,0.95816464237517
02/12/2012,02/12/2012,The Princess Alexandra Hospital NHS Trust,1687,1980,1980,50,1930,0.97474747474747
09/12/2012,09/12/2012,Cambridge University Hospitals NHS Foundation Trust,1885,1885,1885,54,1831,0.97135278514589
09/12/2012,09/12/2012,East And North Hertfordshire NHS Trust,2362,2362,2362,180,2182,0.9237933954276
09/12/2012,09/12/2012,Ipswich Hospital NHS Trust,1398,1398,1398,54,1344,0.96137339055794
09/12/2012,09/12/2012,Mid Essex Hospital Services NHS Trust,1431,1458,1458,104,1354,0.92866941015089
09/12/2012,09/12/2012,The Princess Alexandra Hospital NHS Trust,1696,1944,1944,69,1875,0.96450617283951
16/12/2012,16/12/2012,Cambridge University Hospitals NHS Foundation Trust,1971,1971,1971,109,1862,0.94469812278031
16/12/2012,16/12/2012,East And North Hertfordshire NHS Trust,2334,2334,2334,280,2054,0.88003427592117
16/12/2012,16/12/2012,Ipswich Hospital NHS Trust,1441,1441,1441,70,1371,0.95142262317835
16/12/2012,16/12/2012,Mid Essex Hospital Services NHS Trust,1379,1431,1431,92,1339,0.93570929419986
16/12/2012,16/12/2012,The Princess Alexandra Hospital NHS Trust,1743,2047,2047,94,1953,0.95407914020518
23/12/2012,23/12/2012,Cambridge University Hospitals NHS Foundation Trust,1921,1921,1921,124,1797,0.93545028630921
23/12/2012,23/12/2012,East And North Hertfordshire NHS Trust,2317,2317,2317,176,2141,0.92403970651705
23/12/2012,23/12/2012,Ipswich Hospital NHS Trust,1458,1458,1458,107,1351,0.92661179698217
23/12/2012,23/12/2012,Mid Essex Hospital Services NHS Trust,1472,1537,1537,106,1431,0.93103448275862
23/12/2012,23/12/2012,The Princess Alexandra Hospital NHS Trust,1820,2123,2123,74,2049,0.96514366462553
30/12/2012,30/12/2012,Cambridge University Hospitals NHS Foundation Trust,2118,2118,2118,78,2040,0.96317280453258
30/12/2012,30/12/2012,East And North Hertfordshire NHS Trust,2157,2157,2157,161,1996,0.92535929531757
30/12/2012,30/12/2012,Ipswich Hospital NHS Trust,1494,1494,1494,82,1412,0.94511378848728
30/12/2012,30/12/2012,Mid Essex Hospital Services NHS Trust,1369,1407,1407,48,1359,0.96588486140725
30/12/2012,30/12/2012,The Princess Alexandra Hospital NHS Trust,1727,1989,1989,101,1888,0.9492207139266
06/01/2013,06/01/2013,Cambridge University Hospitals NHS Foundation Trust,1781,1781,1781,98,1683,0.9449747332959
06/01/2013,06/01/2013,East And North Hertfordshire NHS Trust,2291,2291,2291,235,2056,0.89742470536883
06/01/2013,06/01/2013,Ipswich Hospital NHS Trust,1497,1497,1497,66,1431,0.95591182364729
06/01/2013,06/01/2013,Mid Essex Hospital Services NHS Trust,1416,1431,1431,78,1353,0.94549266247379
06/01/2013,06/01/2013,The Princess Alexandra Hospital NHS Trust,1805,2034,2034,315,1719,0.84513274336283
13/01/2013,13/01/2013,Cambridge University Hospitals NHS Foundation Trust,1721,1721,1721,24,1697,0.98605461940732
13/01/2013,13/01/2013,East And North Hertfordshire NHS Trust,2238,2238,2238,112,2126,0.94995531724754
13/01/2013,13/01/2013,Ipswich Hospital NHS Trust,1305,1305,1305,33,1272,0.97471264367816
13/01/2013,13/01/2013,Mid Essex Hospital Services NHS Trust,1360,1380,1380,80,1300,0.94202898550725
13/01/2013,13/01/2013,The Princess Alexandra Hospital NHS Trust,1723,1917,1917,145,1772,0.92436098069901
20/01/2013,20/01/2013,Cambridge University Hospitals NHS Foundation Trust,1682,1682,1682,60,1622,0.96432818073722
20/01/2013,20/01/2013,East And North Hertfordshire NHS Trust,1970,1970,1970,121,1849,0.93857868020305
20/01/2013,20/01/2013,Ipswich Hospital NHS Trust,1349,1349,1349,87,1262,0.93550778354337
20/01/2013,20/01/2013,Mid Essex Hospital Services NHS Trust,1257,1288,1288,64,1224,0.95031055900621
20/01/2013,20/01/2013,The Princess Alexandra Hospital NHS Trust,1566,1732,1732,96,1636,0.9445727482679
27/01/2013,27/01/2013,Cambridge University Hospitals NHS Foundation Trust,1861,1861,1861,88,1773,0.95271359484148
27/01/2013,27/01/2013,East And North Hertfordshire NHS Trust,2337,2337,2337,145,2192,0.93795464270432
27/01/2013,27/01/2013,Ipswich Hospital NHS Trust,1451,1451,1451,119,1332,0.91798759476223
27/01/2013,27/01/2013,Mid Essex Hospital Services NHS Trust,1404,1426,1426,105,1321,0.92636746143058
27/01/2013,27/01/2013,The Princess Alexandra Hospital NHS Trust,1685,1922,1922,64,1858,0.96670135275754
03/02/2013,03/02/2013,Cambridge University Hospitals NHS Foundation Trust,1861,1861,1861,88,1773,0.95271359484148
03/02/2013,03/02/2013,East And North Hertfordshire NHS Trust,2320,2320,2320,110,2210,0.95258620689655
03/02/2013,03/02/2013,Ipswich Hospital NHS Trust,1377,1377,1377,100,1277,0.92737835875091
03/02/2013,03/02/2013,Mid Essex Hospital Services NHS Trust,1585,1621,1621,144,1477,0.91116594694633
03/02/2013,03/02/2013,The Princess Alexandra Hospital NHS Trust,1828,2099,2099,130,1969,0.93806574559314
10/02/2013,10/02/2013,Cambridge University Hospitals NHS Foundation Trust,1929,1929,1929,66,1863,0.96578538102644
10/02/2013,10/02/2013,East And North Hertfordshire NHS Trust,2302,2302,2302,91,2211,0.96046915725456
10/02/2013,10/02/2013,Ipswich Hospital NHS Trust,1361,1361,1361,27,1334,0.98016164584864
10/02/2013,10/02/2013,Mid Essex Hospital Services NHS Trust,1501,1557,1557,27,1530,0.98265895953757
10/02/2013,10/02/2013,The Princess Alexandra Hospital NHS Trust,1841,2058,2058,121,1937,0.94120505344995
17/02/2013,17/02/2013,Cambridge University Hospitals NHS Foundation Trust,1919,1919,1919,132,1787,0.93121417404898
17/02/2013,17/02/2013,East And North Hertfordshire NHS Trust,2317,2317,2317,93,2224,0.95986189037549
17/02/2013,17/02/2013,Ipswich Hospital NHS Trust,1344,1344,1344,64,1280,0.95238095238095
17/02/2013,17/02/2013,Mid Essex Hospital Services NHS Trust,1531,1581,1581,34,1547,0.97849462365591
17/02/2013,17/02/2013,The Princess Alexandra Hospital NHS Trust,1766,1979,1979,116,1863,0.94138453764528
24/02/2013,24/02/2013,Cambridge University Hospitals NHS Foundation Trust,1947,1947,1947,81,1866,0.95839753466872
24/02/2013,24/02/2013,East And North Hertfordshire NHS Trust,2256,2256,2256,68,2188,0.96985815602837
24/02/2013,24/02/2013,Ipswich Hospital NHS Trust,1224,1224,1224,60,1164,0.95098039215686
24/02/2013,24/02/2013,Mid Essex Hospital Services NHS Trust,1472,1521,1521,120,1401,0.92110453648915
24/02/2013,24/02/2013,The Princess Alexandra Hospital NHS Trust,1734,1978,1978,153,1825,0.92264914054601
03/03/2013,03/03/2013,Cambridge University Hospitals NHS Foundation Trust,2046,2046,2046,112,1934,0.94525904203324
03/03/2013,03/03/2013,East And North Hertfordshire NHS Trust,2341,2341,2341,98,2243,0.95813754805639
03/03/2013,03/03/2013,Ipswich Hospital NHS Trust,1387,1387,1387,85,1302,0.93871665465032
03/03/2013,03/03/2013,Mid Essex Hospital Services NHS Trust,1560,1589,1589,88,1501,0.94461925739459
03/03/2013,03/03/2013,The Princess Alexandra Hospital NHS Trust,1836,2065,2065,157,1908,0.92397094430993
10/03/2013,10/03/2013,Cambridge University Hospitals NHS Foundation Trust,2026,2026,2026,263,1763,0.87018756169793
10/03/2013,10/03/2013,East And North Hertfordshire NHS Trust,2471,2471,2471,113,2358,0.95426952650749
10/03/2013,10/03/2013,Ipswich Hospital NHS Trust,1445,1445,1445,145,1300,0.89965397923875
10/03/2013,10/03/2013,Mid Essex Hospital Services NHS Trust,1655,1694,1694,176,1518,0.8961038961039
10/03/2013,10/03/2013,The Princess Alexandra Hospital NHS Trust,1936,2172,2172,216,1956,0.90055248618785
17/03/2013,17/03/2013,Cambridge University Hospitals NHS Foundation Trust,1980,1980,1980,108,1872,0.94545454545455
17/03/2013,17/03/2013,East And North Hertfordshire NHS Trust,2367,2367,2367,142,2225,0.94000844951415
17/03/2013,17/03/2013,Ipswich Hospital NHS Trust,1418,1418,1418,140,1278,0.90126939351199
17/03/2013,17/03/2013,Mid Essex Hospital Services NHS Trust,1449,1505,1505,87,1418,0.9421926910299
17/03/2013,17/03/2013,The Princess Alexandra Hospital NHS Trust,1896,2060,2060,78,1982,0.9621359223301
24/03/2013,24/03/2013,Cambridge University Hospitals NHS Foundation Trust,1986,1986,1986,214,1772,0.89224572004028
24/03/2013,24/03/2013,East And North Hertfordshire NHS Trust,2322,2322,2322,198,2124,0.91472868217054
24/03/2013,24/03/2013,Ipswich Hospital NHS Trust,1334,1334,1334,136,1198,0.89805097451274
24/03/2013,24/03/2013,Mid Essex Hospital Services NHS Trust,1534,1582,1582,32,1550,0.97977243994943
24/03/2013,24/03/2013,The Princess Alexandra Hospital NHS Trust,1858,2090,2090,59,2031,0.97177033492823
31/03/2013,31/03/2013,Cambridge University Hospitals NHS Foundation Trust,1953,1953,1953,151,1802,0.92268305171531
31/03/2013,31/03/2013,East And North Hertfordshire NHS Trust,2359,2359,2359,184,2175,0.92200084781687
31/03/2013,31/03/2013,Ipswich Hospital NHS Trust,1321,1321,1321,119,1202,0.90991672975019
31/03/2013,31/03/2013,Mid Essex Hospital Services NHS Trust,1524,1578,1578,20,1558,0.9873257287706
31/03/2013,31/03/2013,The Princess Alexandra Hospital NHS Trust,1818,2036,2036,11,2025,0.99459724950884
07/04/2013,07/04/2013,Cambridge University Hospitals NHS Foundation Trust,1860,1860,1860,177,1683,0.90483870967742
07/04/2013,07/04/2013,Ipswich Hospital NHS Trust,1386,1386,1386,182,1204,0.86868686868687
07/04/2013,07/04/2013,Mid Essex Hospital Services NHS Trust,1556,1580,1580,117,1463,0.92594936708861
07/04/2013,07/04/2013,The Princess Alexandra Hospital NHS Trust,1999,1999,1999,78,1921,0.96098049024512
07/04/2013,07/04/2013,East And North Hertfordshire NHS Trust,2353,2353,2353,142,2211,0.93965150871228
14/04/2013,14/04/2013,Cambridge University Hospitals NHS Foundation Trust,1931,1931,1931,174,1757,0.909891248058
14/04/2013,14/04/2013,Ipswich Hospital NHS Trust,1397,1397,1397,66,1331,0.95275590551181
14/04/2013,14/04/2013,Mid Essex Hospital Services NHS Trust,1537,1564,1564,25,1539,0.98401534526854
14/04/2013,14/04/2013,The Princess Alexandra Hospital NHS Trust,2068,2068,2068,163,1905,0.92117988394584
14/04/2013,14/04/2013,East And North Hertfordshire NHS Trust,2256,2256,2256,157,2099,0.93040780141844
21/04/2013,21/04/2013,Cambridge University Hospitals NHS Foundation Trust,2036,2036,2036,149,1887,0.92681728880157
21/04/2013,21/04/2013,Ipswich Hospital NHS Trust,1465,1465,1465,42,1423,0.97133105802048
21/04/2013,21/04/2013,Mid Essex Hospital Services NHS Trust,1557,1608,1608,61,1547,0.96206467661692
21/04/2013,21/04/2013,The Princess Alexandra Hospital NHS Trust,2092,2092,2092,149,1943,0.92877629063098
21/04/2013,21/04/2013,East And North Hertfordshire NHS Trust,2424,2424,2424,172,2252,0.92904290429043
28/04/2013,28/04/2013,Cambridge University Hospitals NHS Foundation Trust,2028,2028,2028,100,1928,0.95069033530572
28/04/2013,28/04/2013,Ipswich Hospital NHS Trust,1562,1562,1562,90,1472,0.94238156209987
28/04/2013,28/04/2013,Mid Essex Hospital Services NHS Trust,1633,1668,1668,80,1588,0.95203836930456
28/04/2013,28/04/2013,The Princess Alexandra Hospital NHS Trust,2078,2078,2078,102,1976,0.95091434071222
28/04/2013,28/04/2013,East And North Hertfordshire NHS Trust,2495,2495,2495,100,2395,0.95991983967936
05/05/2013,05/05/2013,Cambridge University Hospitals NHS Foundation Trust,1977,1977,1977,44,1933,0.97774405665149
05/05/2013,05/05/2013,Ipswich Hospital NHS Trust,1615,1615,1615,64,1551,0.96037151702786
05/05/2013,05/05/2013,Mid Essex Hospital Services NHS Trust,1543,1586,1586,74,1512,0.95334174022699
05/05/2013,05/05/2013,The Princess Alexandra Hospital NHS Trust,1994,1994,1994,32,1962,0.9839518555667
05/05/2013,05/05/2013,East And North Hertfordshire NHS Trust,2352,2352,2352,70,2282,0.9702380952381
12/05/2013,12/05/2013,Cambridge University Hospitals NHS Foundation Trust,2023,2023,2023,59,1964,0.97083539298072
12/05/2013,12/05/2013,Ipswich Hospital NHS Trust,1556,1556,1556,52,1504,0.96658097686375
12/05/2013,12/05/2013,Mid Essex Hospital Services NHS Trust,1615,1644,1644,38,1606,0.97688564476886
12/05/2013,12/05/2013,The Princess Alexandra Hospital NHS Trust,2102,2102,2102,69,2033,0.96717411988582
12/05/2013,12/05/2013,East And North Hertfordshire NHS Trust,2517,2517,2517,129,2388,0.94874851013111
19/05/2013,19/05/2013,Cambridge University Hospitals NHS Foundation Trust,1868,1868,1868,141,1727,0.9245182012848
19/05/2013,19/05/2013,Ipswich Hospital NHS Trust,1524,1524,1524,29,1495,0.98097112860892
19/05/2013,19/05/2013,Mid Essex Hospital Services NHS Trust,1605,1644,1644,80,1564,0.95133819951338
19/05/2013,19/05/2013,The Princess Alexandra Hospital NHS Trust,2036,2036,2036,85,1951,0.95825147347741
19/05/2013,19/05/2013,East And North Hertfordshire NHS Trust,2351,2351,2351,99,2252,0.95789025946406
26/05/2013,26/05/2013,Cambridge University Hospitals NHS Foundation Trust,1803,1803,1803,33,1770,0.98169717138103
26/05/2013,26/05/2013,Ipswich Hospital NHS Trust,1434,1434,1434,35,1399,0.97559274755927
26/05/2013,26/05/2013,Mid Essex Hospital Services NHS Trust,1526,1610,1610,84,1526,0.94782608695652
26/05/2013,26/05/2013,The Princess Alexandra Hospital NHS Trust,1992,1992,1992,53,1939,0.97339357429719
26/05/2013,26/05/2013,East And North Hertfordshire NHS Trust,2320,2320,2320,106,2214,0.95431034482759
02/06/2013,02/06/2013,Cambridge University Hospitals NHS Foundation Trust,1875,1875,1875,56,1819,0.97013333333333
02/06/2013,02/06/2013,Ipswich Hospital NHS Trust,1537,1537,1537,61,1476,0.96031229668185
02/06/2013,02/06/2013,Mid Essex Hospital Services NHS Trust,1458,1487,1487,108,1379,0.92737054472091
02/06/2013,02/06/2013,The Princess Alexandra Hospital NHS Trust,2016,2016,2016,99,1917,0.95089285714286
02/06/2013,02/06/2013,East And North Hertfordshire NHS Trust,2177,2177,2177,44,2133,0.97978870004593
09/06/2013,09/06/2013,Cambridge University Hospitals NHS Foundation Trust,1937,1937,1937,72,1865,0.96282911719153
09/06/2013,09/06/2013,Ipswich Hospital NHS Trust,1474,1474,1474,45,1429,0.96947082767978
09/06/2013,09/06/2013,Mid Essex Hospital Services NHS Trust,1487,1513,1513,16,1497,0.98942498347654
09/06/2013,09/06/2013,The Princess Alexandra Hospital NHS Trust,1948,1948,1948,47,1901,0.9758726899384
09/06/2013,09/06/2013,East And North Hertfordshire NHS Trust,2241,2241,2241,96,2145,0.95716198125837
16/06/2013,16/06/2013,Cambridge University Hospitals NHS Foundation Trust,2025,2025,2025,39,1986,0.98074074074074
16/06/2013,16/06/2013,Ipswich Hospital NHS Trust,1403,1403,1403,43,1360,0.96935138987883
16/06/2013,16/06/2013,Mid Essex Hospital Services NHS Trust,1552,1582,1582,45,1537,0.97155499367889
16/06/2013,16/06/2013,The Princess Alexandra Hospital NHS Trust,1989,1989,1989,108,1881,0.94570135746606
16/06/2013,16/06/2013,East And North Hertfordshire NHS Trust,2326,2326,2326,130,2196,0.94411006018917
23/06/2013,23/06/2013,Cambridge University Hospitals NHS Foundation Trust,2065,2065,2065,67,1998,0.96755447941889
23/06/2013,23/06/2013,Ipswich Hospital NHS Trust,1524,1524,1524,51,1473,0.96653543307087
23/06/2013,23/06/2013,Mid Essex Hospital Services NHS Trust,1547,1562,1562,50,1512,0.96798975672215
23/06/2013,23/06/2013,The Princess Alexandra Hospital NHS Trust,2028,2028,2028,29,1999,0.98570019723866
23/06/2013,23/06/2013,East And North Hertfordshire NHS Trust,2429,2429,2429,45,2384,0.98147385755455
30/06/2013,30/06/2013,Cambridge University Hospitals NHS Foundation Trust,2056,2056,2056,60,1996,0.97081712062257
30/06/2013,30/06/2013,Ipswich Hospital NHS Trust,1490,1490,1490,58,1432,0.96107382550336
30/06/2013,30/06/2013,Mid Essex Hospital Services NHS Trust,1561,1569,1569,53,1516,0.96622052262588
30/06/2013,30/06/2013,The Princess Alexandra Hospital NHS Trust,2012,2012,2012,14,1998,0.99304174950298
30/06/2013,30/06/2013,East And North Hertfordshire NHS Trust,2431,2431,2431,44,2387,0.98190045248869
07/07/2013,07/07/2013,Cambridge University Hospitals NHS Foundation Trust,1954,1954,1954,37,1917,0.98106448311157
07/07/2013,07/07/2013,Ipswich Hospital NHS Trust,1568,1568,1568,81,1487,0.94834183673469
07/07/2013,07/07/2013,Mid Essex Hospital Services NHS Trust,1576,1603,1603,52,1551,0.96756082345602
07/07/2013,07/07/2013,The Princess Alexandra Hospital NHS Trust,2037,2037,2037,103,1934,0.94943544428081
07/07/2013,07/07/2013,East And North Hertfordshire NHS Trust,2375,2375,2375,44,2331,0.98147368421053
14/07/2013,14/07/2013,Cambridge University Hospitals NHS Foundation Trust,2056,2056,2056,101,1955,0.95087548638132
14/07/2013,14/07/2013,Ipswich Hospital NHS Trust,1636,1636,1636,55,1581,0.96638141809291
14/07/2013,14/07/2013,Mid Essex Hospital Services NHS Trust,1593,1634,1634,95,1539,0.94186046511628
14/07/2013,14/07/2013,The Princess Alexandra Hospital NHS Trust,2126,2126,2126,108,2018,0.94920037629351
14/07/2013,14/07/2013,East And North Hertfordshire NHS Trust,2525,2525,2525,34,2491,0.98653465346535
21/07/2013,21/07/2013,Cambridge University Hospitals NHS Foundation Trust,2033,2033,2033,99,1934,0.9513034923758
21/07/2013,21/07/2013,Ipswich Hospital NHS Trust,1621,1621,1621,83,1538,0.9487970388649
21/07/2013,21/07/2013,Mid Essex Hospital Services NHS Trust,1621,1654,1654,74,1580,0.9552599758162
21/07/2013,21/07/2013,The Princess Alexandra Hospital NHS Trust,2177,2177,2177,109,2068,0.94993109784107
21/07/2013,21/07/2013,East And North Hertfordshire NHS Trust,2574,2574,2574,74,2500,0.97125097125097
28/07/2013,28/07/2013,Cambridge University Hospitals NHS Foundation Trust,2078,2078,2078,93,1985,0.95524542829644
28/07/2013,28/07/2013,Ipswich Hospital NHS Trust,1608,1608,1608,84,1524,0.94776119402985
28/07/2013,28/07/2013,Mid Essex Hospital Services NHS Trust,1577,1613,1613,92,1521,0.94296342219467
28/07/2013,28/07/2013,The Princess Alexandra Hospital NHS Trust,2039,2039,2039,116,1923,0.94310936733693
28/07/2013,28/07/2013,East And North Hertfordshire NHS Trust,2507,2507,2507,110,2397,0.95612285600319
04/08/2013,04/08/2013,Cambridge University Hospitals NHS Foundation Trust,1988,1988,1988,65,1923,0.96730382293763
04/08/2013,04/08/2013,Ipswich Hospital NHS Trust,1516,1516,1516,53,1463,0.96503957783641
04/08/2013,04/08/2013,Mid Essex Hospital Services NHS Trust,1520,1552,1552,103,1449,0.93363402061856
04/08/2013,04/08/2013,The Princess Alexandra Hospital NHS Trust,1978,1978,1978,23,1955,0.98837209302326
04/08/2013,04/08/2013,East And North Hertfordshire NHS Trust,2344,2344,2344,85,2259,0.96373720136519
11/08/2013,11/08/2013,Cambridge University Hospitals NHS Foundation Trust,1922,1922,1922,122,1800,0.93652445369407
11/08/2013,11/08/2013,Ipswich Hospital NHS Trust,1514,1514,1514,122,1392,0.91941875825627
11/08/2013,11/08/2013,Mid Essex Hospital Services NHS Trust,1511,1543,1543,76,1467,0.95074530136099
11/08/2013,11/08/2013,The Princess Alexandra Hospital NHS Trust,2003,2003,2003,42,1961,0.97903145282077
11/08/2013,11/08/2013,East And North Hertfordshire NHS Trust,2353,2353,2353,57,2296,0.97577560560986
18/08/2013,18/08/2013,Cambridge University Hospitals NHS Foundation Trust,1827,1827,1827,103,1724,0.94362342638205
18/08/2013,18/08/2013,Ipswich Hospital NHS Trust,1505,1505,1505,76,1429,0.94950166112957
18/08/2013,18/08/2013,Mid Essex Hospital Services NHS Trust,1544,1567,1567,114,1453,0.92724952137843
18/08/2013,18/08/2013,The Princess Alexandra Hospital NHS Trust,1875,1875,1875,77,1798,0.95893333333333
18/08/2013,18/08/2013,East And North Hertfordshire NHS Trust,2309,2309,2309,88,2221,0.96188826331745
25/08/2013,25/08/2013,Ipswich Hospital NHS Trust,1518,1518,1518,113,1405,0.92555994729908
25/08/2013,25/08/2013,Cambridge University Hospitals NHS Foundation Trust,2002,2002,2002,119,1883,0.94055944055944
25/08/2013,25/08/2013,Mid Essex Hospital Services NHS Trust,1483,1508,1508,95,1413,0.93700265251989
25/08/2013,25/08/2013,The Princess Alexandra Hospital NHS Trust,1914,1914,1914,83,1831,0.95663531870428
25/08/2013,25/08/2013,East And North Hertfordshire NHS Trust,2387,2387,2387,103,2284,0.95684960201089
01/09/2013,01/09/2013,Cambridge University Hospitals NHS Foundation Trust,1891,1891,1891,65,1826,0.96562665256478
01/09/2013,01/09/2013,Ipswich Hospital NHS Trust,1591,1591,1591,133,1458,0.91640477686989
01/09/2013,01/09/2013,Mid Essex Hospital Services NHS Trust,1543,1565,1565,135,1430,0.91373801916933
01/09/2013,01/09/2013,The Princess Alexandra Hospital NHS Trust,1960,1960,1960,65,1895,0.96683673469388
01/09/2013,01/09/2013,East And North Hertfordshire NHS Trust,2417,2417,2417,89,2328,0.96317749275962
08/09/2013,08/09/2013,Cambridge University Hospitals NHS Foundation Trust,1890,1890,1890,96,1794,0.94920634920635
08/09/2013,08/09/2013,Ipswich Hospital NHS Trust,1548,1548,1548,159,1389,0.89728682170543
08/09/2013,08/09/2013,Mid Essex Hospital Services NHS Trust,1499,1524,1524,96,1428,0.93700787401575
08/09/2013,08/09/2013,The Princess Alexandra Hospital NHS Trust,1989,1989,1989,69,1920,0.96530920060332
08/09/2013,08/09/2013,East And North Hertfordshire NHS Trust,2344,2344,2344,81,2263,0.96544368600683
15/09/2013,15/09/2013,Cambridge University Hospitals NHS Foundation Trust,1839,1839,1839,69,1770,0.96247960848287
15/09/2013,15/09/2013,Ipswich Hospital NHS Trust,1396,1396,1396,53,1343,0.96203438395415
15/09/2013,15/09/2013,Mid Essex Hospital Services NHS Trust,1507,1524,1524,39,1485,0.9744094488189
15/09/2013,15/09/2013,The Princess Alexandra Hospital NHS Trust,1869,1869,1869,59,1810,0.96843231674692
15/09/2013,15/09/2013,East And North Hertfordshire NHS Trust,2131,2131,2131,79,2052,0.96292820272173
22/09/2013,22/09/2013,Cambridge University Hospitals NHS Foundation Trust,1908,1908,1908,77,1831,0.95964360587002
22/09/2013,22/09/2013,Ipswich Hospital NHS Trust,1567,1567,1567,50,1517,0.96809189534142
22/09/2013,22/09/2013,Mid Essex Hospital Services NHS Trust,1504,1528,1528,43,1485,0.97185863874346
22/09/2013,22/09/2013,The Princess Alexandra Hospital NHS Trust,1813,1813,1813,51,1762,0.97186982901269
22/09/2013,22/09/2013,East And North Hertfordshire NHS Trust,2312,2312,2312,118,2194,0.94896193771626
29/09/2013,29/09/2013,Cambridge University Hospitals NHS Foundation Trust,1957,1957,1957,117,1840,0.94021461420542
29/09/2013,29/09/2013,Ipswich Hospital NHS Trust,1530,1530,1530,38,1492,0.97516339869281
29/09/2013,29/09/2013,Mid Essex Hospital Services NHS Trust,1517,1546,1546,6,1540,0.99611901681759
29/09/2013,29/09/2013,The Princess Alexandra Hospital NHS Trust,2076,2076,2076,198,1878,0.90462427745665
29/09/2013,29/09/2013,East And North Hertfordshire NHS Trust,2391,2391,2391,126,2265,0.94730238393977
06/10/2013,06/10/2013,Cambridge University Hospitals NHS Foundation Trust,2032,2032,2032,77,1955,0.9621062992126
06/10/2013,06/10/2013,Ipswich Hospital NHS Trust,1487,1487,1487,53,1434,0.96435776731675
06/10/2013,06/10/2013,Mid Essex Hospital Services NHS Trust,1578,1611,1611,20,1591,0.98758535071384
06/10/2013,06/10/2013,The Princess Alexandra Hospital NHS Trust,1979,1979,1979,138,1841,0.93026781202628
06/10/2013,06/10/2013,East And North Hertfordshire NHS Trust,2419,2419,2419,62,2357,0.97436957420422
13/10/2013,13/10/2013,Cambridge University Hospitals NHS Foundation Trust,1970,1970,1970,120,1850,0.93908629441624
13/10/2013,13/10/2013,Ipswich Hospital NHS Trust,1455,1455,1455,31,1424,0.9786941580756
13/10/2013,13/10/2013,Mid Essex Hospital Services NHS Trust,1502,1519,1519,15,1504,0.99012508229098
13/10/2013,13/10/2013,The Princess Alexandra Hospital NHS Trust,1976,1976,1976,74,1902,0.96255060728745
13/10/2013,13/10/2013,East And North Hertfordshire NHS Trust,2404,2404,2404,69,2335,0.97129783693844
20/10/2013,20/10/2013,Cambridge University Hospitals NHS Foundation Trust,1986,1986,1986,173,1813,0.91289023162135
20/10/2013,20/10/2013,Ipswich Hospital NHS Trust,1486,1486,1486,72,1414,0.95154777927322
20/10/2013,20/10/2013,Mid Essex Hospital Services NHS Trust,1481,1523,1523,9,1514,0.9940906106369
20/10/2013,20/10/2013,The Princess Alexandra Hospital NHS Trust,1987,1987,1987,66,1921,0.96678409662808
20/10/2013,20/10/2013,East And North Hertfordshire NHS Trust,2351,2351,2351,57,2294,0.97575499787325
27/10/2013,27/10/2013,Cambridge University Hospitals NHS Foundation Trust,2056,2056,2056,130,1926,0.93677042801556
27/10/2013,27/10/2013,Ipswich Hospital NHS Trust,1463,1463,1463,55,1408,0.96240601503759
27/10/2013,27/10/2013,Mid Essex Hospital Services NHS Trust,1513,1553,1553,28,1525,0.98197037990985
27/10/2013,27/10/2013,The Princess Alexandra Hospital NHS Trust,2063,2063,2063,118,1945,0.94280174503151
27/10/2013,27/10/2013,East And North Hertfordshire NHS Trust,2319,2319,2319,65,2254,0.97197067701596
03/11/2013,03/11/2013,Cambridge University Hospitals NHS Foundation Trust,1911,1911,1911,85,1826,0.95552066980638
03/11/2013,03/11/2013,Ipswich Hospital NHS Trust,1448,1448,1448,70,1378,0.95165745856354
03/11/2013,03/11/2013,Mid Essex Hospital Services NHS Trust,1459,1490,1490,34,1456,0.97718120805369
03/11/2013,03/11/2013,The Princess Alexandra Hospital NHS Trust,1901,1901,1901,101,1800,0.94687006838506
03/11/2013,03/11/2013,East And North Hertfordshire NHS Trust,2181,2181,2181,45,2136,0.97936726272352
10/11/2013,10/11/2013,Cambridge University Hospitals NHS Foundation Trust,2042,2042,2042,238,1804,0.88344760039177
10/11/2013,10/11/2013,Ipswich Hospital NHS Trust,1437,1437,1437,97,1340,0.93249826026444
10/11/2013,10/11/2013,Mid Essex Hospital Services NHS Trust,1610,1640,1640,94,1546,0.94268292682927
10/11/2013,10/11/2013,The Princess Alexandra Hospital NHS Trust,1919,1919,1919,95,1824,0.95049504950495
10/11/2013,10/11/2013,East And North Hertfordshire NHS Trust,2282,2282,2282,73,2209,0.96801051709027
17/11/2013,17/11/2013,Cambridge University Hospitals NHS Foundation Trust,1924,1924,1924,94,1830,0.95114345114345
17/11/2013,17/11/2013,Ipswich Hospital NHS Trust,1462,1462,1462,102,1360,0.93023255813953
17/11/2013,17/11/2013,Mid Essex Hospital Services NHS Trust,1467,1514,1514,65,1449,0.95706737120211
17/11/2013,17/11/2013,The Princess Alexandra Hospital NHS Trust,2004,2004,2004,75,1929,0.9625748502994
17/11/2013,17/11/2013,East And North Hertfordshire NHS Trust,2239,2239,2239,44,2195,0.98034836980795
24/11/2013,24/11/2013,Cambridge University Hospitals NHS Foundation Trust,1978,1978,1978,129,1849,0.93478260869565
24/11/2013,24/11/2013,Ipswich Hospital NHS Trust,1448,1448,1448,69,1379,0.95234806629834
24/11/2013,24/11/2013,Mid Essex Hospital Services NHS Trust,1456,1511,1511,60,1451,0.9602911978822
24/11/2013,24/11/2013,The Princess Alexandra Hospital NHS Trust,1960,1960,1960,105,1855,0.94642857142857
24/11/2013,24/11/2013,East And North Hertfordshire NHS Trust,2261,2261,2261,85,2176,0.96240601503759
01/12/2013,01/12/2013,Cambridge University Hospitals NHS Foundation Trust,1978,1978,1978,167,1811,0.91557128412538
01/12/2013,01/12/2013,Ipswich Hospital NHS Trust,1430,1430,1430,53,1377,0.96293706293706
01/12/2013,01/12/2013,Mid Essex Hospital Services NHS Trust,1477,1518,1518,49,1469,0.96772068511199
01/12/2013,01/12/2013,The Princess Alexandra Hospital NHS Trust,1995,1995,1995,229,1766,0.88521303258145
01/12/2013,01/12/2013,East And North Hertfordshire NHS Trust,2491,2491,2491,173,2318,0.93054997992774
08/12/2013,08/12/2013,Cambridge University Hospitals NHS Foundation Trust,2077,2077,2077,238,1839,0.88541165142032
08/12/2013,08/12/2013,Ipswich Hospital NHS Trust,1492,1492,1492,110,1382,0.92627345844504
08/12/2013,08/12/2013,Mid Essex Hospital Services NHS Trust,1583,1646,1646,123,1523,0.92527339003645
08/12/2013,08/12/2013,The Princess Alexandra Hospital NHS Trust,2071,2071,2071,215,1856,0.89618541767262
08/12/2013,08/12/2013,East And North Hertfordshire NHS Trust,2416,2416,2416,110,2306,0.9544701986755
15/12/2013,15/12/2013,Cambridge University Hospitals NHS Foundation Trust,1992,1992,1992,207,1785,0.8960843373494
15/12/2013,15/12/2013,Ipswich Hospital NHS Trust,1550,1550,1550,68,1482,0.95612903225806
15/12/2013,15/12/2013,Mid Essex Hospital Services NHS Trust,1543,1591,1591,105,1486,0.93400377121307
15/12/2013,15/12/2013,The Princess Alexandra Hospital NHS Trust,2040,2040,2040,254,1786,0.87549019607843
15/12/2013,15/12/2013,East And North Hertfordshire NHS Trust,2506,2506,2506,257,2249,0.8974461292897
22/12/2013,22/12/2013,Cambridge University Hospitals NHS Foundation Trust,1995,1995,1995,113,1882,0.94335839598997
22/12/2013,22/12/2013,Ipswich Hospital NHS Trust,1498,1498,1498,57,1441,0.96194926568758
22/12/2013,22/12/2013,Mid Essex Hospital Services NHS Trust,1451,1501,1501,52,1449,0.9653564290473
22/12/2013,22/12/2013,The Princess Alexandra Hospital NHS Trust,1909,1909,1909,209,1700,0.89051859612362
22/12/2013,22/12/2013,East And North Hertfordshire NHS Trust,2358,2358,2358,121,2237,0.94868532654792
29/12/2013,29/12/2013,Cambridge University Hospitals NHS Foundation Trust,1742,1742,1742,69,1673,0.96039035591274
29/12/2013,29/12/2013,Ipswich Hospital NHS Trust,1459,1459,1459,42,1417,0.97121315969842
29/12/2013,29/12/2013,Mid Essex Hospital Services NHS Trust,1250,1281,1281,77,1204,0.93989071038251
29/12/2013,29/12/2013,The Princess Alexandra Hospital NHS Trust,1834,1834,1834,147,1687,0.91984732824427
29/12/2013,29/12/2013,East And North Hertfordshire NHS Trust,2081,2081,2081,91,1990,0.95627102354637
05/01/2014,05/01/2014,Cambridge University Hospitals NHS Foundation Trust,1794,1794,1794,90,1704,0.94983277591973
05/01/2014,05/01/2014,Ipswich Hospital NHS Trust,1426,1426,1426,35,1391,0.97545582047686
05/01/2014,05/01/2014,Mid Essex Hospital Services NHS Trust,1466,1497,1497,51,1446,0.96593186372745
05/01/2014,05/01/2014,The Princess Alexandra Hospital NHS Trust,1897,1897,1897,267,1630,0.85925144965735
05/01/2014,05/01/2014,East And North Hertfordshire NHS Trust,2173,2173,2173,133,2040,0.93879429360331
12/01/2014,12/01/2014,Cambridge University Hospitals NHS Foundation Trust,1833,1833,1833,136,1697,0.92580469176214
12/01/2014,12/01/2014,Ipswich Hospital NHS Trust,1322,1322,1322,16,1306,0.98789712556732
12/01/2014,12/01/2014,Mid Essex Hospital Services NHS Trust,1404,1435,1435,36,1399,0.97491289198606
12/01/2014,12/01/2014,The Princess Alexandra Hospital NHS Trust,1896,1896,1896,206,1690,0.89135021097046
12/01/2014,12/01/2014,East And North Hertfordshire NHS Trust,2294,2294,2294,134,2160,0.94158674803836
19/01/2014,19/01/2014,Cambridge University Hospitals NHS Foundation Trust,1862,1862,1862,64,1798,0.9656283566058
19/01/2014,19/01/2014,Ipswich Hospital NHS Trust,1406,1406,1406,21,1385,0.9850640113798
19/01/2014,19/01/2014,Mid Essex Hospital Services NHS Trust,1435,1476,1476,88,1388,0.94037940379404
19/01/2014,19/01/2014,The Princess Alexandra Hospital NHS Trust,1864,1864,1864,84,1780,0.9549356223176
19/01/2014,19/01/2014,East And North Hertfordshire NHS Trust,2335,2335,2335,124,2211,0.94689507494647
26/01/2014,26/01/2014,Cambridge University Hospitals NHS Foundation Trust,1927,1927,1927,50,1877,0.97405293201868
26/01/2014,26/01/2014,Ipswich Hospital NHS Trust,1388,1388,1388,15,1373,0.98919308357349
26/01/2014,26/01/2014,Mid Essex Hospital Services NHS Trust,1407,1451,1451,146,1305,0.89937973811165
26/01/2014,26/01/2014,The Princess Alexandra Hospital NHS Trust,1860,1860,1860,25,1835,0.98655913978495
26/01/2014,26/01/2014,East And North Hertfordshire NHS Trust,2330,2330,2330,65,2265,0.97210300429185
02/02/2014,02/02/2014,Cambridge University Hospitals NHS Foundation Trust,1929,1929,1929,56,1873,0.97096941420425
02/02/2014,02/02/2014,Ipswich Hospital NHS Trust,1397,1397,1397,33,1364,0.97637795275591
02/02/2014,02/02/2014,Mid Essex Hospital Services NHS Trust,1484,1533,1533,71,1462,0.95368558382257
02/02/2014,02/02/2014,The Princess Alexandra Hospital NHS Trust,1981,1981,1981,59,1922,0.97021706208985
02/02/2014,02/02/2014,East And North Hertfordshire NHS Trust,2460,2460,2460,58,2402,0.97642276422764
09/02/2014,09/02/2014,Cambridge University Hospitals NHS Foundation Trust,1996,1996,1996,142,1854,0.92885771543086
09/02/2014,09/02/2014,Ipswich Hospital NHS Trust,1511,1511,1511,60,1451,0.9602911978822
09/02/2014,09/02/2014,Mid Essex Hospital Services NHS Trust,1477,1539,1539,88,1451,0.94282001299545
09/02/2014,09/02/2014,The Princess Alexandra Hospital NHS Trust,1957,1957,1957,193,1764,0.90137966274911
09/02/2014,09/02/2014,East And North Hertfordshire NHS Trust,2409,2409,2409,103,2306,0.95724366957244
16/02/2014,16/02/2014,Cambridge University Hospitals NHS Foundation Trust,1996,1996,1996,142,1854,0.92885771543086
16/02/2014,16/02/2014,Ipswich Hospital NHS Trust,1511,1511,1511,60,1451,0.9602911978822
16/02/2014,16/02/2014,Mid Essex Hospital Services NHS Trust,1477,1539,1539,88,1451,0.94282001299545
16/02/2014,16/02/2014,The Princess Alexandra Hospital NHS Trust,1957,1957,1957,193,1764,0.90137966274911
16/02/2014,16/02/2014,East And North Hertfordshire NHS Trust,2409,2409,2409,103,2306,0.95724366957244
23/02/2014,23/02/2014,Cambridge University Hospitals NHS Foundation Trust,2027,2027,2027,60,1967,0.97039960532807
23/02/2014,23/02/2014,Ipswich Hospital NHS Trust,1357,1357,1357,22,1335,0.98378776713338
23/02/2014,23/02/2014,Mid Essex Hospital Services NHS Trust,1413,1440,1440,146,1294,0.89861111111111
23/02/2014,23/02/2014,The Princess Alexandra Hospital NHS Trust,1943,1943,1943,105,1838,0.94595985589295
23/02/2014,23/02/2014,East And North Hertfordshire NHS Trust,2387,2387,2387,221,2166,0.90741516547968
02/03/2014,02/03/2014,Cambridge University Hospitals NHS Foundation Trust,2041,2041,2041,123,1918,0.93973542381186
02/03/2014,02/03/2014,Ipswich Hospital NHS Trust,1547,1547,1547,50,1497,0.96767937944409
02/03/2014,02/03/2014,Mid Essex Hospital Services NHS Trust,1521,1588,1588,138,1450,0.91309823677582
02/03/2014,02/03/2014,The Princess Alexandra Hospital NHS Trust,1980,1980,1980,72,1908,0.96363636363636
02/03/2014,02/03/2014,East And North Hertfordshire NHS Trust,2479,2479,2479,112,2367,0.95482049213393
09/03/2014,09/03/2014,Cambridge University Hospitals NHS Foundation Trust,2189,2189,2189,149,2040,0.93193238921882
09/03/2014,09/03/2014,Ipswich Hospital NHS Trust,1576,1576,1576,33,1543,0.97906091370558
09/03/2014,09/03/2014,Mid Essex Hospital Services NHS Trust,1673,1701,1701,158,1543,0.90711346266902
09/03/2014,09/03/2014,The Princess Alexandra Hospital NHS Trust,2156,2156,2156,271,1885,0.87430426716141
09/03/2014,09/03/2014,East And North Hertfordshire NHS Trust,2563,2563,2563,206,2357,0.91962543893874
16/03/2014,16/03/2014,Cambridge University Hospitals NHS Foundation Trust,2204,2204,2204,137,2067,0.93784029038113
16/03/2014,16/03/2014,Ipswich Hospital NHS Trust,1544,1544,1544,31,1513,0.97992227979275
16/03/2014,16/03/2014,Mid Essex Hospital Services NHS Trust,1692,1758,1758,136,1622,0.9226393629124
16/03/2014,16/03/2014,The Princess Alexandra Hospital NHS Trust,2098,2098,2098,169,1929,0.91944709246902
16/03/2014,16/03/2014,East And North Hertfordshire NHS Trust,2635,2635,2635,124,2511,0.95294117647059
23/03/2014,23/03/2014,Cambridge University Hospitals NHS Foundation Trust,2075,2075,2075,209,1866,0.89927710843373
23/03/2014,23/03/2014,Ipswich Hospital NHS Trust,1611,1611,1611,40,1571,0.97517070142768
23/03/2014,23/03/2014,Mid Essex Hospital Services NHS Trust,1724,1772,1772,166,1606,0.90632054176072
23/03/2014,23/03/2014,The Princess Alexandra Hospital NHS Trust,2161,2161,2161,193,1968,0.91068949560389
23/03/2014,23/03/2014,East And North Hertfordshire NHS Trust,2697,2697,2697,134,2563,0.95031516499815
30/03/2014,30/03/2014,Cambridge University Hospitals NHS Foundation Trust,2398,2398,2398,248,2150,0.89658048373645
30/03/2014,30/03/2014,Ipswich Hospital NHS Trust,1507,1507,1507,46,1461,0.96947577969476
30/03/2014,30/03/2014,Mid Essex Hospital Services NHS Trust,1667,1717,1717,56,1661,0.9673849737915
30/03/2014,30/03/2014,The Princess Alexandra Hospital NHS Trust,2165,2165,2165,185,1980,0.91454965357968
30/03/2014,30/03/2014,East And North Hertfordshire NHS Trust,2565,2565,2565,106,2459,0.95867446393762
06/04/2014,06/04/2014,Cambridge University Hospitals NHS Foundation Trust,2157,2157,2157,217,1940,0.8993973110802
06/04/2014,06/04/2014,Ipswich Hospital NHS Trust,1601,1601,1601,48,1553,0.97001873828857
06/04/2014,06/04/2014,Mid Essex Hospital Services NHS Trust,1681,1731,1731,150,1581,0.91334488734835
06/04/2014,06/04/2014,The Princess Alexandra Hospital NHS Trust,2175,2175,2175,246,1929,0.88689655172414
06/04/2014,06/04/2014,East And North Hertfordshire NHS Trust,2593,2593,2593,186,2407,0.92826841496336
13/04/2014,13/04/2014,Cambridge University Hospitals NHS Foundation Trust,1923,1923,1923,137,1786,0.92875715028601
13/04/2014,13/04/2014,Ipswich Hospital NHS Trust,1496,1496,1496,54,1442,0.96390374331551
13/04/2014,13/04/2014,Mid Essex Hospital Services NHS Trust,1565,1594,1594,116,1478,0.92722710163112
13/04/2014,13/04/2014,The Princess Alexandra Hospital NHS Trust,2047,2047,2047,190,1857,0.90718124084025
13/04/2014,13/04/2014,East And North Hertfordshire NHS Trust,2427,2427,2427,154,2273,0.9365471775855
20/04/2014,20/04/2014,Cambridge University Hospitals NHS Foundation Trust,2013,2013,2013,122,1891,0.93939393939394
20/04/2014,20/04/2014,Ipswich Hospital NHS Trust,1629,1629,1629,27,1602,0.98342541436464
20/04/2014,20/04/2014,Mid Essex Hospital Services NHS Trust,1596,1640,1640,235,1405,0.85670731707317
20/04/2014,20/04/2014,The Princess Alexandra Hospital NHS Trust,2019,2019,2019,59,1960,0.97077761267954
20/04/2014,20/04/2014,East And North Hertfordshire NHS Trust,2298,2298,2298,123,2175,0.94647519582245
27/04/2014,27/04/2014,Cambridge University Hospitals NHS Foundation Trust,2232,2232,2232,244,1988,0.89068100358423
27/04/2014,27/04/2014,Ipswich Hospital NHS Trust,1627,1627,1627,66,1561,0.95943454210203
27/04/2014,27/04/2014,Mid Essex Hospital Services NHS Trust,1676,1724,1724,179,1545,0.8961716937355
27/04/2014,27/04/2014,The Princess Alexandra Hospital NHS Trust,2232,2232,2232,209,2023,0.90636200716846
27/04/2014,27/04/2014,East And North Hertfordshire NHS Trust,2467,2467,2467,299,2168,0.87880016214025
04/05/2014,04/05/2014,Cambridge University Hospitals NHS Foundation Trust,2073,2073,2073,210,1863,0.8986975397974
04/05/2014,04/05/2014,Ipswich Hospital NHS Trust,1487,1487,1487,35,1452,0.97646267652993
04/05/2014,04/05/2014,Mid Essex Hospital Services NHS Trust,1651,1711,1711,130,1581,0.92402104032729
04/05/2014,04/05/2014,The Princess Alexandra Hospital NHS Trust,2096,2096,2096,199,1897,0.9050572519084
04/05/2014,04/05/2014,East And North Hertfordshire NHS Trust,2506,2506,2506,240,2266,0.90422984836393
11/05/2014,11/05/2014,Cambridge University Hospitals NHS Foundation Trust,2220,2220,2220,255,1965,0.88513513513514
11/05/2014,11/05/2014,Ipswich Hospital NHS Trust,1519,1519,1519,51,1468,0.96642527978934
11/05/2014,11/05/2014,Mid Essex Hospital Services NHS Trust,1691,1727,1727,190,1537,0.88998262883613
11/05/2014,11/05/2014,The Princess Alexandra Hospital NHS Trust,2192,2192,2192,251,1941,0.88549270072993
11/05/2014,11/05/2014,East And North Hertfordshire NHS Trust,2577,2577,2577,256,2321,0.90065968180054
18/05/2014,18/05/2014,Cambridge University Hospitals NHS Foundation Trust,2197,2197,2197,253,1944,0.8848429676832
18/05/2014,18/05/2014,Ipswich Hospital NHS Trust,1577,1577,1577,44,1533,0.9720989220038
18/05/2014,18/05/2014,Mid Essex Hospital Services NHS Trust,1708,1750,1750,109,1641,0.93771428571429
18/05/2014,18/05/2014,The Princess Alexandra Hospital NHS Trust,2116,2116,2116,201,1915,0.90500945179584
18/05/2014,18/05/2014,East And North Hertfordshire NHS Trust,2691,2691,2691,173,2518,0.93571163136381
25/05/2014,25/05/2014,Cambridge University Hospitals NHS Foundation Trust,2196,2196,2196,279,1917,0.87295081967213
25/05/2014,25/05/2014,Ipswich Hospital NHS Trust,1509,1509,1509,38,1471,0.97481776010603
25/05/2014,25/05/2014,Mid Essex Hospital Services NHS Trust,1702,1738,1738,143,1595,0.91772151898734
25/05/2014,25/05/2014,The Princess Alexandra Hospital NHS Trust,2180,2180,2180,212,1968,0.90275229357798
25/05/2014,25/05/2014,East And North Hertfordshire NHS Trust,2595,2595,2595,137,2458,0.94720616570328
01/06/2014,01/06/2014,Cambridge University Hospitals NHS Foundation Trust,2091,2091,2091,147,1944,0.92969870875179
01/06/2014,01/06/2014,Ipswich Hospital NHS Trust,1432,1432,1432,14,1418,0.99022346368715
01/06/2014,01/06/2014,Mid Essex Hospital Services NHS Trust,1631,1668,1668,117,1551,0.92985611510791
01/06/2014,01/06/2014,The Princess Alexandra Hospital NHS Trust,1968,1968,1968,241,1727,0.8775406504065
01/06/2014,01/06/2014,East And North Hertfordshire NHS Trust,2366,2366,2366,149,2217,0.93702451394759
08/06/2014,08/06/2014,Cambridge University Hospitals NHS Foundation Trust,2149,2149,2149,243,1906,0.8869241507678
08/06/2014,08/06/2014,Ipswich Hospital NHS Trust,1566,1566,1566,44,1522,0.97190293742018
08/06/2014,08/06/2014,Mid Essex Hospital Services NHS Trust,1676,1721,1721,267,1454,0.84485764090645
08/06/2014,08/06/2014,The Princess Alexandra Hospital NHS Trust,2061,2061,2061,263,1798,0.87239204269772
08/06/2014,08/06/2014,East And North Hertfordshire NHS Trust,2567,2567,2567,128,2439,0.9501363459291
15/06/2014,15/06/2014,Cambridge University Hospitals NHS Foundation Trust,2200,2200,2200,268,1932,0.87818181818182
15/06/2014,15/06/2014,Ipswich Hospital NHS Trust,1672,1672,1672,47,1625,0.97188995215311
15/06/2014,15/06/2014,Mid Essex Hospital Services NHS Trust,1763,1806,1806,180,1626,0.90033222591362
15/06/2014,15/06/2014,The Princess Alexandra Hospital NHS Trust,2145,2145,2145,168,1977,0.92167832167832
15/06/2014,15/06/2014,East And North Hertfordshire NHS Trust,2685,2685,2685,69,2616,0.97430167597765
22/06/2014,22/06/2014,Cambridge University Hospitals NHS Foundation Trust,2181,2181,2181,230,1951,0.89454378725355
22/06/2014,22/06/2014,Ipswich Hospital NHS Trust,1569,1569,1569,22,1547,0.98597833014659
22/06/2014,22/06/2014,Mid Essex Hospital Services NHS Trust,1667,1707,1707,51,1656,0.9701230228471
22/06/2014,22/06/2014,The Princess Alexandra Hospital NHS Trust,2062,2062,2062,156,1906,0.92434529582929
22/06/2014,22/06/2014,East And North Hertfordshire NHS Trust,2642,2642,2642,100,2542,0.96214988644966
29/06/2014,29/06/2014,Cambridge University Hospitals NHS Foundation Trust,2159,2159,2159,299,1860,0.86150995831403
29/06/2014,29/06/2014,Ipswich Hospital NHS Trust,1618,1618,1618,48,1570,0.97033374536465
29/06/2014,29/06/2014,Mid Essex Hospital Services NHS Trust,1699,1736,1736,91,1645,0.94758064516129
29/06/2014,29/06/2014,The Princess Alexandra Hospital NHS Trust,2086,2086,2086,93,1993,0.95541706615532
29/06/2014,29/06/2014,East And North Hertfordshire NHS Trust,2757,2757,2757,190,2567,0.93108451215089
06/07/2014,06/07/2014,Cambridge University Hospitals NHS Foundation Trust,2098,2098,2098,295,1803,0.85938989513823
06/07/2014,06/07/2014,Ipswich Hospital NHS Trust,1584,1584,1584,82,1502,0.94823232323232
06/07/2014,06/07/2014,Mid Essex Hospital Services NHS Trust,1604,1629,1629,48,1581,0.97053406998158
06/07/2014,06/07/2014,The Princess Alexandra Hospital NHS Trust,2110,2110,2110,168,1942,0.92037914691943
06/07/2014,06/07/2014,East And North Hertfordshire NHS Trust,2699,2699,2699,106,2593,0.960726194887
13/07/2014,13/07/2014,Cambridge University Hospitals NHS Foundation Trust,2118,2118,2118,246,1872,0.88385269121813
13/07/2014,13/07/2014,Ipswich Hospital NHS Trust,1556,1556,1556,52,1504,0.96658097686375
13/07/2014,13/07/2014,Mid Essex Hospital Services NHS Trust,1744,1793,1793,134,1659,0.92526491912995
13/07/2014,13/07/2014,The Princess Alexandra Hospital NHS Trust,2056,2056,2056,204,1852,0.90077821011673
13/07/2014,13/07/2014,East And North Hertfordshire NHS Trust,2636,2636,2636,194,2442,0.92640364188164
20/07/2014,20/07/2014,Cambridge University Hospitals NHS Foundation Trust,2244,2244,2244,166,2078,0.92602495543672
20/07/2014,20/07/2014,Ipswich Hospital NHS Trust,1715,1715,1715,75,1640,0.95626822157434
20/07/2014,20/07/2014,Mid Essex Hospital Services NHS Trust,1623,1663,1663,81,1582,0.95129284425737
20/07/2014,20/07/2014,East And North Hertfordshire NHS Trust,2623,2623,2623,131,2492,0.95005718642775
27/07/2014,27/07/2014,Cambridge University Hospitals NHS Foundation Trust,2167,2167,2167,165,2002,0.9238578680203
27/07/2014,27/07/2014,Ipswich Hospital NHS Trust,1717,1717,1717,73,1644,0.95748398369249
27/07/2014,27/07/2014,Mid Essex Hospital Services NHS Trust,1692,1721,1721,36,1685,0.97908192911098
27/07/2014,27/07/2014,The Princess Alexandra Hospital NHS Trust,2054,2054,2054,200,1854,0.90262901655307
27/07/2014,27/07/2014,East And North Hertfordshire NHS Trust,2595,2595,2595,74,2521,0.97148362235067
03/08/2014,03/08/2014,Cambridge University Hospitals NHS Foundation Trust,2078,2078,2078,98,1980,0.95283926852743
03/08/2014,03/08/2014,Ipswich Hospital NHS Trust,1547,1547,1547,30,1517,0.98060762766645
03/08/2014,03/08/2014,Mid Essex Hospital Services NHS Trust,1573,1609,1609,55,1554,0.96581727781231
03/08/2014,03/08/2014,The Princess Alexandra Hospital NHS Trust,1862,1862,1862,98,1764,0.94736842105263
03/08/2014,03/08/2014,East And North Hertfordshire NHS Trust,2508,2508,2508,120,2388,0.95215311004785
10/08/2014,10/08/2014,Cambridge University Hospitals NHS Foundation Trust,2023,2023,2023,183,1840,0.90954028670292
10/08/2014,10/08/2014,Ipswich Hospital NHS Trust,1519,1519,1519,40,1479,0.97366688610928
10/08/2014,10/08/2014,Mid Essex Hospital Services NHS Trust,1601,1640,1640,95,1545,0.94207317073171
10/08/2014,10/08/2014,The Princess Alexandra Hospital NHS Trust,1935,1935,1935,195,1740,0.89922480620155
10/08/2014,10/08/2014,East And North Hertfordshire NHS Trust,2309,2309,2309,150,2159,0.93503681247293
17/08/2014,17/08/2014,Cambridge University Hospitals NHS Foundation Trust,1932,1932,1932,149,1783,0.92287784679089
17/08/2014,17/08/2014,Ipswich Hospital NHS Trust,1463,1463,1463,48,1415,0.96719070403281
17/08/2014,17/08/2014,Mid Essex Hospital Services NHS Trust,1564,1594,1594,113,1481,0.92910915934755
17/08/2014,17/08/2014,The Princess Alexandra Hospital NHS Trust,1811,1811,1811,240,1571,0.8674765323026
17/08/2014,17/08/2014,East And North Hertfordshire NHS Trust,2204,2204,2204,127,2077,0.94237749546279
24/08/2014,24/08/2014,Cambridge University Hospitals NHS Foundation Trust,1818,1818,1818,65,1753,0.96424642464246
24/08/2014,24/08/2014,Ipswich Hospital NHS Trust,1478,1478,1478,30,1448,0.97970230040595
24/08/2014,24/08/2014,Mid Essex Hospital Services NHS Trust,1547,1580,1580,121,1459,0.92341772151899
24/08/2014,24/08/2014,The Princess Alexandra Hospital NHS Trust,1810,1810,1810,153,1657,0.91546961325967
24/08/2014,24/08/2014,East And North Hertfordshire NHS Trust,2239,2239,2239,142,2097,0.93657882983475
31/08/2014,31/08/2014,Cambridge University Hospitals NHS Foundation Trust,1929,1929,1929,114,1815,0.94090202177294
31/08/2014,31/08/2014,Ipswich Hospital NHS Trust,1527,1527,1527,30,1497,0.9803536345776
31/08/2014,31/08/2014,Mid Essex Hospital Services NHS Trust,1608,1626,1626,361,1265,0.7779827798278
31/08/2014,31/08/2014,The Princess Alexandra Hospital NHS Trust,1902,1902,1902,229,1673,0.87960042060988
31/08/2014,31/08/2014,East And North Hertfordshire NHS Trust,2388,2388,2388,142,2246,0.94053601340033
07/09/2014,07/09/2014,Cambridge University Hospitals NHS Foundation Trust,1977,1977,1977,146,1831,0.9261507334345
07/09/2014,07/09/2014,Ipswich Hospital NHS Trust,1498,1498,1498,32,1466,0.97863818424566
07/09/2014,07/09/2014,Mid Essex Hospital Services NHS Trust,1643,1665,1665,176,1489,0.89429429429429
07/09/2014,07/09/2014,The Princess Alexandra Hospital NHS Trust,1943,1943,1943,297,1646,0.84714359238291
07/09/2014,07/09/2014,East And North Hertfordshire NHS Trust,2527,2527,2527,226,2301,0.91056588840522
14/09/2014,14/09/2014,Cambridge University Hospitals NHS Foundation Trust,2042,2042,2042,169,1873,0.91723800195886
14/09/2014,14/09/2014,Ipswich Hospital NHS Trust,1551,1551,1551,55,1496,0.9645390070922
14/09/2014,14/09/2014,Mid Essex Hospital Services NHS Trust,1654,1701,1701,144,1557,0.91534391534392
14/09/2014,14/09/2014,The Princess Alexandra Hospital NHS Trust,1901,1901,1901,151,1750,0.92056812204103
14/09/2014,14/09/2014,East And North Hertfordshire NHS Trust,2513,2513,2513,226,2287,0.91006764822921
21/09/2014,21/09/2014,Cambridge University Hospitals NHS Foundation Trust,2079,2079,2079,162,1917,0.92207792207792
21/09/2014,21/09/2014,Ipswich Hospital NHS Trust,1550,1550,1550,40,1510,0.9741935483871
21/09/2014,21/09/2014,Mid Essex Hospital Services NHS Trust,1704,1743,1743,189,1554,0.89156626506024
21/09/2014,21/09/2014,The Princess Alexandra Hospital NHS Trust,2073,2073,2073,182,1891,0.91220453449108
21/09/2014,21/09/2014,East And North Hertfordshire NHS Trust,2587,2587,2587,257,2330,0.90065713181291
28/09/2014,28/09/2014,Cambridge University Hospitals NHS Foundation Trust,2077,2077,2077,240,1837,0.88444872412133
28/09/2014,28/09/2014,Ipswich Hospital NHS Trust,1584,1584,1584,29,1555,0.98169191919192
28/09/2014,28/09/2014,Mid Essex Hospital Services NHS Trust,1709,1737,1737,157,1580,0.90961427748993
28/09/2014,28/09/2014,The Princess Alexandra Hospital NHS Trust,1986,1986,1986,130,1856,0.93454179254783
28/09/2014,28/09/2014,East And North Hertfordshire NHS Trust,2550,2550,2550,141,2409,0.94470588235294
05/10/2014,05/10/2014,Cambridge University Hospitals NHS Foundation Trust,2067,2067,2067,178,1889,0.91388485728108
05/10/2014,05/10/2014,Ipswich Hospital NHS Trust,1534,1534,1534,52,1482,0.96610169491525
05/10/2014,05/10/2014,Mid Essex Hospital Services NHS Trust,1706,1750,1750,194,1556,0.88914285714286
05/10/2014,05/10/2014,The Princess Alexandra Hospital NHS Trust,2109,2109,2109,118,1991,0.94404931247037
05/10/2014,05/10/2014,East And North Hertfordshire NHS Trust,2601,2601,2601,268,2333,0.89696270665129
12/10/2014,12/10/2014,Cambridge University Hospitals NHS Foundation Trust,2081,2081,2081,241,1840,0.8841902931283
12/10/2014,12/10/2014,Ipswich Hospital NHS Trust,1464,1464,1464,50,1414,0.96584699453552
12/10/2014,12/10/2014,Mid Essex Hospital Services NHS Trust,1560,1605,1605,172,1433,0.89283489096573
12/10/2014,12/10/2014,The Princess Alexandra Hospital NHS Trust,1969,1969,1969,147,1822,0.92534281361097
12/10/2014,12/10/2014,East And North Hertfordshire NHS Trust,2420,2420,2420,230,2190,0.90495867768595
19/10/2014,19/10/2014,Cambridge University Hospitals NHS Foundation Trust,2137,2137,2137,242,1895,0.8867571361722
19/10/2014,19/10/2014,Ipswich Hospital NHS Trust,1606,1606,1606,53,1553,0.96699875466999
19/10/2014,19/10/2014,Mid Essex Hospital Services NHS Trust,1587,1627,1627,142,1485,0.91272280270436
19/10/2014,19/10/2014,The Princess Alexandra Hospital NHS Trust,2138,2138,2138,253,1885,0.88166510757718
19/10/2014,19/10/2014,East And North Hertfordshire NHS Trust,2626,2626,2626,302,2324,0.88499619192688
26/10/2014,26/10/2014,Cambridge University Hospitals NHS Foundation Trust,2024,2024,2024,303,1721,0.85029644268775
26/10/2014,26/10/2014,Ipswich Hospital NHS Trust,1478,1478,1478,53,1425,0.96414073071719
26/10/2014,26/10/2014,Mid Essex Hospital Services NHS Trust,1728,1766,1766,222,1544,0.87429218573046
26/10/2014,26/10/2014,The Princess Alexandra Hospital NHS Trust,2025,2025,2025,144,1881,0.92888888888889
26/10/2014,26/10/2014,East And North Hertfordshire NHS Trust,2155,2621,2621,209,2412,0.9202594429607
02/11/2014,02/11/2014,Cambridge University Hospitals NHS Foundation Trust,2126,2126,2126,851,1275,0.5997177798683
02/11/2014,02/11/2014,Ipswich Hospital NHS Trust,1422,1422,1422,64,1358,0.9549929676512
02/11/2014,02/11/2014,Mid Essex Hospital Services NHS Trust,1601,1649,1649,240,1409,0.85445724681625
02/11/2014,02/11/2014,The Princess Alexandra Hospital NHS Trust,1923,1923,1923,108,1815,0.94383775351014
02/11/2014,02/11/2014,East And North Hertfordshire NHS Trust,2062,2441,2441,141,2300,0.94223678820156
07/12/2014,07/12/2014,Cambridge University Hospitals NHS Foundation Trust,1967,1967,1967,468,1499,0.76207422470768
07/12/2014,07/12/2014,Ipswich Hospital NHS Trust,1469,1469,1469,71,1398,0.95166780122532
07/12/2014,07/12/2014,Mid Essex Hospital Services NHS Trust,1650,1725,1725,229,1496,0.86724637681159
07/12/2014,07/12/2014,The Princess Alexandra Hospital NHS Trust,1995,1995,1995,464,1531,0.76741854636591
07/12/2014,07/12/2014,East And North Hertfordshire NHS Trust,2060,2474,2474,278,2196,0.88763136620857
09/11/2014,09/11/2014,Cambridge University Hospitals NHS Foundation Trust,2113,2113,2113,786,1327,0.628
09/11/2014,09/11/2014,Ipswich Hospital NHS Trust,1439,1439,1439,50,1389,0.965
09/11/2014,09/11/2014,Mid Essex Hospital Services NHS Trust,1593,1643,1643,118,1525,0.928
09/11/2014,09/11/2014,The Princess Alexandra Hospital NHS Trust,1942,1942,1942,144,1798,0.926
09/11/2014,09/11/2014,East And North Hertfordshire NHS Trust,2109,2575,2575,150,2425,0.942
16/11/2014,16/11/2014,Cambridge University Hospitals NHS Foundation Trust,2187,2187,2187,629,1558,0.712
16/11/2014,16/11/2014,Ipswich Hospital NHS Trust,1491,1491,1491,55,1436,0.963
16/11/2014,16/11/2014,Mid Essex Hospital Services NHS Trust,1653,1706,1706,96,1610,0.944
16/11/2014,16/11/2014,The Princess Alexandra Hospital NHS Trust,2026,2026,2026,189,1837,0.907
16/11/2014,16/11/2014,East And North Hertfordshire NHS Trust,2172,2604,2604,212,2392,0.919
23/11/2014,23/11/2014,Cambridge University Hospitals NHS Foundation Trust,2059,2059,2059,441,1618,0.786
23/11/2014,23/11/2014,Ipswich Hospital NHS Trust,1385,1385,1385,44,1341,0.968
23/11/2014,23/11/2014,Mid Essex Hospital Services NHS Trust,1610,1664,1664,154,1510,0.907
23/11/2014,23/11/2014,The Princess Alexandra Hospital NHS Trust,1966,1966,1966,137,1829,0.93
23/11/2014,23/11/2014,East And North Hertfordshire NHS Trust,2112,2557,2557,179,2378,0.93
30/11/2014,30/11/2014,Cambridge University Hospitals NHS Foundation Trust,2096,2096,2096,613,1483,0.708
30/11/2014,30/11/2014,Ipswich Hospital NHS Trust,1455,1455,1455,58,1397,0.96
30/11/2014,30/11/2014,Mid Essex Hospital Services NHS Trust,1633,1702,1702,245,1457,0.856
30/11/2014,30/11/2014,The Princess Alexandra Hospital NHS Trust,2006,2006,2006,328,1678,0.836
30/11/2014,30/11/2014,East And North Hertfordshire NHS Trust,2033,2482,2482,124,2358,0.95
14/12/2014,14/12/2014,Cambridge University Hospitals NHS Foundation Trust,2061,2061,2061,679,1382,0.671
14/12/2014,14/12/2014,Ipswich Hospital NHS Trust,1593,1593,1593,90,1503,0.944
14/12/2014,14/12/2014,Mid Essex Hospital Services NHS Trust,1687,1745,1745,369,1376,0.789
14/12/2014,14/12/2014,The Princess Alexandra Hospital NHS Trust,1999,1999,1999,418,1581,0.791
14/12/2014,14/12/2014,East And North Hertfordshire NHS Trust,1958,2471,2471,355,2116,0.856
21/12/2014,21/12/2014,Cambridge University Hospitals NHS Foundation Trust,1968,1968,1968,573,1395,0.709
21/12/2014,21/12/2014,Ipswich Hospital NHS Trust,1563,1563,1563,94,1469,0.94
21/12/2014,21/12/2014,Mid Essex Hospital Services NHS Trust,1723,1791,1791,355,1436,0.802
21/12/2014,21/12/2014,The Princess Alexandra Hospital NHS Trust,2109,2109,2109,530,1579,0.749
21/12/2014,21/12/2014,East And North Hertfordshire NHS Trust,1988,2497,2497,358,2139,0.857
28/12/2014,28/12/2014,Cambridge University Hospitals NHS Foundation Trust,1816,1816,1816,617,1199,0.66
28/12/2014,28/12/2014,Ipswich Hospital NHS Trust,1511,1511,1511,98,1413,0.935
28/12/2014,28/12/2014,Mid Essex Hospital Services NHS Trust,1561,1593,1593,207,1386,0.87
28/12/2014,28/12/2014,The Princess Alexandra Hospital NHS Trust,1855,1855,1855,416,1439,0.776
28/12/2014,28/12/2014,East And North Hertfordshire NHS Trust,1838,2256,2256,348,1908,0.846
04/01/2015,04/01/2015,Cambridge University Hospitals NHS Foundation Trust,1792,1792,1792,515,1277,0.713
04/01/2015,04/01/2015,Ipswich Hospital NHS Trust,1467,1467,1467,133,1334,0.909
04/01/2015,04/01/2015,Mid Essex Hospital Services NHS Trust,1506,1556,1556,383,1173,0.754
04/01/2015,04/01/2015,The Princess Alexandra Hospital NHS Trust,1794,1794,1794,553,1241,0.692
04/01/2015,04/01/2015,East And North Hertfordshire NHS Trust,1879,2331,2331,580,1751,0.751
11/01/2015,11/01/2015,Cambridge University Hospitals NHS Foundation Trust,1671,1671,1671,351,1320,0.79
11/01/2015,11/01/2015,Ipswich Hospital NHS Trust,1426,1426,1426,120,1306,0.916
11/01/2015,11/01/2015,Mid Essex Hospital Services NHS Trust,1505,1547,1547,353,1194,0.772
11/01/2015,11/01/2015,The Princess Alexandra Hospital NHS Trust,1664,1664,1664,358,1306,0.785
11/01/2015,11/01/2015,East And North Hertfordshire NHS Trust,1698,2128,2128,300,1828,0.859
18/01/2015,18/01/2015,Cambridge University Hospitals NHS Foundation Trust,1677,1677,1677,256,1421,0.847
18/01/2015,18/01/2015,Ipswich Hospital NHS Trust,1398,1398,1398,48,1350,0.966
18/01/2015,18/01/2015,Mid Essex Hospital Services NHS Trust,1477,1504,1504,330,1174,0.781
18/01/2015,18/01/2015,The Princess Alexandra Hospital NHS Trust,1650,1650,1650,469,1181,0.716
18/01/2015,18/01/2015,East And North Hertfordshire NHS Trust,1693,2140,2140,135,2005,0.937
25/02/2015,25/02/2015,Cambridge University Hospitals NHS Foundation Trust,1755,1755,1755,260,1495,0.852
25/02/2015,25/02/2015,Ipswich Hospital NHS Trust,1445,1445,1445,68,1377,0.953
25/02/2015,25/02/2015,Mid Essex Hospital Services NHS Trust,1558,1603,1603,294,1309,0.817
25/02/2015,25/02/2015,The Princess Alexandra Hospital NHS Trust,1627,1627,1627,338,1289,0.792
25/02/2015,25/02/2015,East And North Hertfordshire NHS Trust,1765,2228,2228,102,2126,0.954
01/02/2015,01/02/2015,Cambridge University Hospitals NHS Foundation Trust,1841,1841,1841,340,1501,0.815
01/02/2015,01/02/2015,Ipswich Hospital NHS Trust,1482,1482,1482,98,1384,0.934
01/02/2015,01/02/2015,Mid Essex Hospital Services NHS Trust,1514,1569,1569,386,1183,0.754
01/02/2015,01/02/2015,The Princess Alexandra Hospital NHS Trust,1683,1717,1717,340,1377,0.802
01/02/2015,01/02/2015,East And North Hertfordshire NHS Trust,1745,2254,2254,205,2049,0.909
08/02/2015,08/02/2015,Cambridge University Hospitals NHS Foundation Trust,1819,1819,1819,218,1601,0.88
08/02/2015,08/02/2015,Ipswich Hospital NHS Trust,1579,1579,1579,124,1455,0.921
08/02/2015,08/02/2015,Mid Essex Hospital Services NHS Trust,1473,1522,1522,316,1206,0.792
08/02/2015,08/02/2015,The Princess Alexandra Hospital NHS Trust,1719,1759,1759,173,1586,0.902
08/02/2015,08/02/2015,East And North Hertfordshire NHS Trust,1797,2313,2313,176,2137,0.924
15/02/2015,15/02/2015,Cambridge University Hospitals NHS Foundation Trust,1952,1952,1952,490,1462,0.749
15/02/2015,15/02/2015,Ipswich Hospital NHS Trust,1574,1574,1574,78,1496,0.95
15/02/2015,15/02/2015,Mid Essex Hospital Services NHS Trust,1556,1606,1606,289,1317,0.82
15/02/2015,15/02/2015,The Princess Alexandra Hospital NHS Trust,1751,1786,1786,233,1553,0.87
15/02/2015,15/02/2015,East And North Hertfordshire NHS Trust,1911,2449,2449,239,2210,0.902
22/02/2015,22/02/2015,Cambridge University Hospitals NHS Foundation Trust,1910,1910,1910,417,1493,0.782
22/02/2015,22/02/2015,Ipswich Hospital NHS Trust,1436,1436,1436,65,1371,0.955
22/02/2015,22/02/2015,Mid Essex Hospital Services NHS Trust,1552,1584,1584,317,1267,0.8
22/02/2015,22/02/2015,The Princess Alexandra Hospital NHS Trust,1642,1692,1692,135,1557,0.92
22/02/2015,22/02/2015,East And North Hertfordshire NHS Trust,1786,2295,2295,143,2152,0.938
01/03/2015,01/03/2015,Cambridge University Hospitals NHS Foundation Trust,1987,1987,1987,510,1477,0.743
01/03/2015,01/03/2015,Ipswich Hospital NHS Trust,1509,1509,1509,88,1421,0.942
01/03/2015,01/03/2015,Mid Essex Hospital Services NHS Trust,1655,1718,1718,399,1319,0.768
01/03/2015,01/03/2015,The Princess Alexandra Hospital NHS Trust,1759,1784,1784,326,1458,0.817
01/03/2015,01/03/2015,East And North Hertfordshire NHS Trust,1991,2548,2548,93,2455,0.964
08/03/2015,08/03/2015,Cambridge University Hospitals NHS Foundation Trust,1939,1939,1939,472,1467,0.75657555440949
08/03/2015,08/03/2015,Ipswich Hospital NHS Trust,1519,1519,1519,44,1475,0.97103357472021
08/03/2015,08/03/2015,Mid Essex Hospital Services NHS Trust,1643,1694,1694,213,1481,0.87426210153483
08/03/2015,08/03/2015,The Princess Alexandra Hospital NHS Trust,1794,1840,1840,422,1418,0.77065217391304
08/03/2015,08/03/2015,East And North Hertfordshire NHS Trust,1986,2571,2571,175,2396,0.9319330999611
15/03/2015,15/03/2015,Cambridge University Hospitals NHS Foundation Trust,2035,2035,2035,436,1599,0.78574938574939
15/03/2015,15/03/2015,Ipswich Hospital NHS Trust,1495,1495,1495,36,1459,0.97591973244147
15/03/2015,15/03/2015,Mid Essex Hospital Services NHS Trust,1779,1823,1823,340,1483,0.8134942402633
15/03/2015,15/03/2015,The Princess Alexandra Hospital NHS Trust,1745,1792,1792,200,1592,0.88839285714286
15/03/2015,15/03/2015,East And North Hertfordshire NHS Trust,1942,2469,2469,69,2400,0.97205346294046
22/03/2015,22/03/2015,Cambridge University Hospitals NHS Foundation Trust,2084,2084,2084,509,1575,0.75575815738964
22/03/2015,22/03/2015,Ipswich Hospital NHS Trust,1520,1520,1520,22,1498,0.98552631578947
22/03/2015,22/03/2015,Mid Essex Hospital Services NHS Trust,1731,1791,1791,368,1423,0.79452819653825
22/03/2015,22/03/2015,The Princess Alexandra Hospital NHS Trust,1787,1845,1845,185,1660,0.89972899728997
22/03/2015,22/03/2015,East And North Hertfordshire NHS Trust,1967,2570,2570,140,2430,0.94552529182879
29/03/2015,29/03/2015,Cambridge University Hospitals NHS Foundation Trust,1986,1986,1986,420,1566,0.78851963746224
29/03/2015,29/03/2015,Ipswich Hospital NHS Trust,1605,1605,1605,42,1563,0.97383177570093
29/03/2015,29/03/2015,Mid Essex Hospital Services NHS Trust,1609,1655,1655,414,1241,0.74984894259819
29/03/2015,29/03/2015,The Princess Alexandra Hospital NHS Trust,1739,1782,1782,150,1632,0.91582491582492
29/03/2015,29/03/2015,East And North Hertfordshire NHS Trust,2009,2164,2164,149,2015,0.931146025878
